first_year_payment,yearly_payments,down_payment,adjusted_price,lat,lon,price,usage,style
130191,31396,98795,493975,42.258382,-71.159455,287500,1-FAM RES,COLONIAL
123518,17541,105977,326762,42.338462,-71.152457,185000,CONDOMINIUM,LOW-RISE
320732,77347,243385,1216925,42.362099,-71.050169,899000,CONDOMINIUM,MID-RISE
279182,67327,211855,1059275,42.281325,-71.092649,580000,WAREHOUSE,CONDO/APT
4103521,262306,3841215,7142756,42.354791,-71.072323,4867787,CONDOMINIUM,MID-RISE
862374,16604,845770,1054763,42.351787,-71.067367,807500,CONDOMINIUM,HIGH-RISE
301772,33544,268228,690437,42.356178,-71.137586,556000,1-FAM RES,CONVENTIONAL
80901,19510,61391,306958,42.280399,-71.097058,235000,2-FAM RES,TWO FAMILY
96394,23246,73148,365738,42.324641,-71.095486,280000,3-FAM RES,DECKER
236953,57143,179810,899047,42.292091,-71.071787,700000,4-8 UNIT APT,CONDO/APT
1214262,292830,921432,4607159,42.35337,-71.062515,3475000,CONDOMINIUM,HIGH-RISE
314827,75923,238904,1194520,42.35337,-71.062515,845000,CONDOMINIUM,HIGH-RISE
405870,97879,307991,1539952,42.35337,-71.062515,1085000,CONDOMINIUM,HIGH-RISE
84626,20408,64218,321088,42.295308,-71.082405,250000,1-FAM RES,COLONIAL
469981,113340,356641,1783202,42.351787,-71.067367,1345000,CONDOMINIUM,HIGH-RISE
561516,135414,426102,2130510,42.351787,-71.067367,1895000,CONDOMINIUM,HIGH-RISE
367339,88587,278752,1393758,42.351787,-71.067367,1170000,CONDOMINIUM,HIGH-RISE
633300,152726,480574,2402870,42.351787,-71.067367,1935000,CONDOMINIUM,HIGH-RISE
1678287,404734,1273553,6367764,42.351787,-71.067367,4875000,CONDOMINIUM,HIGH-RISE
519191,125207,393984,1969919,42.351787,-71.067367,1342500,CONDOMINIUM,HIGH-RISE
419199,101093,318106,1590530,42.351787,-71.067367,1175000,CONDOMINIUM,HIGH-RISE
1093300,263659,829641,4148203,42.351787,-71.067367,2750000,CONDOMINIUM,HIGH-RISE
387834,93529,294305,1471525,42.351787,-71.067367,1185000,CONDOMINIUM,HIGH-RISE
15698,3785,11913,59562,42.294399,-71.152088,50000,1-FAM RES,COLONIAL
1631047,393341,1237706,6188526,42.345267,-71.084125,5195000,CONDOMINIUM,HIGH-RISE
1989796,382983,1606813,6427251,42.345267,-71.084125,5300000,CONDOMINIUM,HIGH-RISE
2013582,485593,1527989,7639941,42.345267,-71.084125,6300000,CONDOMINIUM,HIGH-RISE
3416513,823923,2592590,12962948,42.345267,-71.084125,11530000,CONDOMINIUM,HIGH-RISE
3335875,804476,2531399,12656995,42.345267,-71.084125,10625000,CONDOMINIUM,HIGH-RISE
2904175,700368,2203807,11019031,42.345267,-71.084125,9250000,CONDOMINIUM,HIGH-RISE
4238524,1022158,3216366,16081829,42.345267,-71.084125,13500000,CONDOMINIUM,HIGH-RISE
1956235,501009,1455226,7761209,42.345267,-71.084125,6400000,CONDOMINIUM,HIGH-RISE
1956235,501009,1455226,7761209,42.345267,-71.084125,6400000,CONDOMINIUM,HIGH-RISE
1997601,481739,1515862,7579306,42.345267,-71.084125,6250000,CONDOMINIUM,HIGH-RISE
2077505,501009,1576496,7882478,42.348853,-71.074296,6500000,CONDOMINIUM,HIGH-RISE
5048919,283932,4764987,8338726,42.345267,-71.084125,7000000,CONDOMINIUM,HIGH-RISE
11365206,757154,10608052,20138024,42.345267,-71.084125,16905000,CONDOMINIUM,HIGH-RISE
10674803,2574326,8100477,40502384,42.345267,-71.084125,34000000,CONDOMINIUM,HIGH-RISE
145316,35044,110272,551356,42.280424,-71.166574,444000,1-FAM RES,CAPE COD
188057,45351,142706,713530,42.318763,-71.099068,555556,4-8 UNIT APT,CONDO/APT
1569824,378577,1191247,5956233,42.352014,-71.083471,5000000,3-FAM RES,ROW-END
156724,37795,118929,594644,42.365432,-71.052907,405250,CONDOMINIUM,MID-RISE
156724,37795,118929,594644,42.365432,-71.052907,405250,CONDOMINIUM,MID-RISE
223636,53931,169705,848521,42.325638,-71.07782,660000,3-FAM RES,ROW-END
1457687,280566,1177121,4708484,42.356057,-71.059157,4000000,CONDOMINIUM,HIGH-RISE
2133437,514497,1618940,8094699,42.356057,-71.059157,6675000,CONDOMINIUM,HIGH-RISE
265083,63927,201156,1005780,42.361064,-71.067029,770000,CONDOMINIUM,ROW-END
1502196,362268,1139928,5699638,42.349359,-71.076991,4700000,CONDOMINIUM,HIGH-RISE
568072,136995,431077,2155381,42.349359,-71.076991,1700000,CONDOMINIUM,HIGH-RISE
635924,153358,482566,2412828,42.358046,-71.068377,1700000,CONDOMINIUM,ROW-END
101653,24514,77139,385691,42.307877,-71.086595,300000,2-FAM RES,CONVENTIONAL
690928,108054,582874,1942912,42.352044,-71.082059,1100000,CONDOMINIUM,ROW-MIDDLE
869135,209599,659536,3297678,42.375326,-71.060356,1950000,OTHER EXEMPT,ROW-END
376757,90858,285899,1429495,42.386134,-71.076518,1200000,MXU COM+RES,RAISED CAPE
376757,90858,285899,1429495,42.386127,-71.076509,1200000,1-FAM RES,SEMI DETACHD
2046045,493422,1552623,7763114,42.357217,-71.071921,6595000,4-8 UNIT APT,CONDO/APT
116705,33180,83525,417627,42.259132,-71.125144,315000,1-FAM RES,COLONIAL
161692,38993,122699,613492,42.242456,-71.138066,515000,2-FAM RES,DUPLEX
253877,61224,192653,963265,42.303659,-71.118058,750000,2-FAM RES,CONVENTIONAL
109639,26440,83199,415994,42.363479,-71.066446,283500,CONDOMINIUM,HIGH-RISE
153236,29493,123743,494970,42.316226,-71.063253,385000,3-FAM RES,ROW-END
811135,0,811135,811136,42.337475,-71.075668,571500,CONDOMINIUM,ROW-END
169421,40857,128564,642818,42.379647,-71.064351,500000,2-FAM RES,ROW-END
283184,54418,228766,913709,42.348426,-71.169755,675000,2-FAM RES,CONVENTIONAL
502552,48722,453830,1067079,42.353385,-71.135761,830000,2-FAM RES,ROW-END
282320,68084,214236,1071180,42.317004,-71.06236,910000,3-FAM RES,DECKER
289456,69804,219652,1098256,42.326414,-71.102429,854250,4-8 UNIT APT,CONDO/APT
109648,67196,42452,888221,42.387043,-71.006611,680000,4-8 UNIT APT,CONDO/APT
426731,82134,344597,1378390,42.320283,-71.092473,1110000,CONDOMINIUM,FREE-STANDNG
426731,82134,344597,1378390,42.320283,-71.092473,1110000,CONDOMINIUM,FREE-STANDNG
414138,73452,340686,1265202,42.332383,-71.099961,895000,3-FAM RES,DECKER
760501,154156,606345,2546647,42.328277,-71.057042,2100000,4-8 UNIT APT,CONDO/APT
412144,112004,300140,1709891,42.292882,-71.062372,1410000,OTHER EXEMPT,CONDO/APT
490930,118392,372538,1862690,42.330032,-71.100501,1500000,2-FAM RES,CONVENTIONAL
323787,44395,279392,838175,42.330032,-71.100501,600000,2-FAM RES,CONVENTIONAL
1130273,272575,857698,4288487,42.342097,-71.082644,3600000,4-8 UNIT APT,ROW-MIDDLE
444472,107188,337284,1686419,42.341755,-71.079273,1500000,CONDOMINIUM,ROW-MIDDLE
150827,36373,114454,572267,42.318921,-71.055987,390000,3-FAM RES,DECKER
47676,32517,15159,424441,42.266536,-71.114047,350000,1-FAM RES,CAPE COD
325946,78604,247342,1236708,42.319716,-71.064326,1100000,3-FAM RES,DECKER
272674,65757,206917,1034582,42.28747,-71.077969,816000,2-FAM RES,CONVENTIONAL
954152,230102,724050,3620250,42.351876,-71.08315,2400000,9 + UNIT APT,CONDO/APT
216925,33925,183000,609999,42.306498,-71.062699,467000,3-FAM RES,DECKER
170952,41226,129726,648628,42.306498,-71.062699,430000,3-FAM RES,DECKER
194658,46943,147715,738572,42.367057,-71.038597,620000,1-FAM RES,SEMI DETACHD
59730,14404,45326,226627,42.314987,-71.08193,182500,CONDOMINIUM,SEMI DETACHD
71932,17347,54585,272925,42.313008,-71.102167,212500,MXU RES+COM,SEMI DETACHD
26207,6320,19887,99435,42.302576,-71.06683,75000,1-FAM RES,COLONIAL
305264,73617,231647,1158233,42.36634,-71.032696,1030200,4-8 UNIT APT,CONDO/APT
214950,51837,163113,815564,42.36634,-71.032696,635000,4-8 UNIT APT,CONDO/APT
52637,12693,39944,199716,42.266851,-71.112281,155500,1-FAM RES,CAPE COD
313965,75715,238250,1191246,42.285525,-71.145845,1000000,3-FAM RES,DECKER
77934,18794,59140,295696,42.325899,-71.082588,230000,1-FAM RES,ROW-MIDDLE
183280,44199,139081,695404,42.328193,-71.07933,560000,3-FAM RES,ROW-END
221772,42685,179087,716347,42.334859,-71.046602,565000,2-FAM RES,TWO FAMILY
559328,134887,424441,2122205,42.35712,-71.071928,1750000,CONDOMINIUM,MID-RISE
423852,102215,321637,1608182,42.374822,-71.063094,1350000,MXU RES+COM,SEMI DETACHD
168306,40588,127718,638588,42.350857,-71.133695,542500,CONDOMINIUM,LOW-RISE
52366,12628,39738,198686,42.270661,-71.094635,160000,1-FAM RES,BNGL/COTTAGE
97839,23594,74245,371224,42.329652,-71.086379,280000,COM DEV LAND,CONDO/APT
645277,155614,489663,2448311,42.341258,-71.077878,1725000,2-FAM RES,ROW-MIDDLE
85388,20592,64796,323980,42.292474,-71.054165,252000,2-FAM RES,CONVENTIONAL
160737,38763,121974,609868,42.286688,-71.077956,460000,3-FAM RES,DECKER
210383,50735,159648,798238,42.281952,-71.089137,710000,3-FAM RES,DECKER
205531,32143,173388,577959,42.3552,-71.126413,450000,1-FAM RES,CONVENTIONAL
1624966,107188,1517778,2866914,42.341128,-71.081361,2550000,4-8 UNIT APT,CONDO/APT
1050412,253316,797096,3985477,42.364087,-71.056446,3100000,9 + UNIT APT,CONDO/APT
42098,10152,31946,159729,42.317768,-71.073476,118000,1-FAM RES,COLONIAL
346985,83678,263307,1316531,42.351936,-71.169281,1171000,2-FAM RES,CONVENTIONAL
72196,17410,54786,273927,42.287997,-71.080119,193000,3-FAM RES,DECKER
4099995,988751,3111244,15556219,42.348951,-71.130359,12100000,9 + UNIT APT,CONDO/APT
82476,19889,62587,312931,42.275233,-71.127048,252000,1-FAM RES,COLONIAL
918577,221523,697054,3485267,42.35531,-71.073021,3100000,CONDOMINIUM,MID-RISE
1885735,454762,1430973,7154865,42.346046,-71.083886,5900000,CONDOMINIUM,HIGH-RISE
25391,6123,19268,96339,42.33043,-71.055077,68150,CONDOMINIUM,FREE-STANDNG
277375,117728,159647,1641448,42.334306,-71.041401,1460000,3-FAM RES,DECKER
218317,34142,184175,613917,42.299314,-71.143417,470000,1-FAM RES,RANCH
202100,48738,153362,766807,42.310465,-71.076974,617500,3-FAM RES,ROW-MIDDLE
2096986,378811,1718175,6486110,42.342849,-71.088408,3775000,9 + UNIT APT,CONDO/APT
87894,21196,66698,333489,42.257872,-71.11651,275000,1-FAM RES,COLONIAL
178208,42976,135232,676158,42.312191,-71.05889,510000,4-8 UNIT APT,CONDO/APT
3210894,774336,2436558,12182787,42.355395,-71.073063,9000000,CONDOMINIUM,MID-RISE
14756,3558,11198,55988,42.321486,-71.08555,47000,3-FAM RES,CONVENTIONAL
102038,24607,77431,387155,42.344346,-71.14423,325000,CONDOMINIUM,LOW-RISE
102038,24607,77431,387155,42.344266,-71.143872,325000,CONDOMINIUM,LOW-RISE
220535,53184,167351,836755,42.377649,-71.035873,690000,3-FAM RES,CONVENTIONAL
36611613,5295273,31316340,97965610,42.27739,-71.069464,75000000,1-FAM RES,RANCH
2307318,674557,1632761,10123113,42.355292,-71.072767,7750000,9 + UNIT APT,CONDO/APT
252010,42811,209199,748044,42.357369,-71.052621,590000,CONDOMINIUM,MID-RISE
144008,34728,109280,546396,42.381876,-71.0353,425000,2-FAM RES,TWO FAMILY
61121,31927,29194,431048,42.306324,-71.078818,330000,3-FAM RES,CONVENTIONAL
52366,12628,39738,198686,42.250807,-71.111711,160000,RES DEV LAND,COLONIAL
204733,49373,155360,776797,42.365871,-71.056315,499000,CONDOMINIUM,ROW-END
414841,100042,314799,1573992,42.376658,-71.035966,1400000,MXU RES+COM,RAISED CAPE
259937,62686,197251,986253,42.366097,-71.051114,706000,OFFICE CONDO,ROW-MIDDLE
740787,178647,562140,2810700,42.387083,-71.005842,2500000,MXU RES+COM,CONDO/APT
450012,90805,359207,1502139,42.264815,-71.12267,1150000,2-FAM RES,DUPLEX
504497,119845,384652,1893089,42.366496,-71.051362,1255000,CONDOMINIUM,MID-RISE
1783713,430158,1353555,6767775,42.346289,-71.073103,5450000,9 + UNIT APT,CONDO/APT
201281,48540,152741,763703,42.366432,-71.035465,615000,3-FAM RES,ROW-MIDDLE
64647,48072,16575,621647,42.37248,-71.035929,445000,4-8 UNIT APT,CONDO/APT
234350,56515,177835,889175,42.361896,-71.052821,629000,CONDOMINIUM,ROW-MIDDLE
186944,45083,141861,709303,42.336498,-71.040717,535000,CONDOMINIUM,DECKER
203779,49143,154636,773178,42.336803,-71.08516,450000,MXU RES+COM,CONDO/APT
792511,191121,601390,3006946,42.336776,-71.085209,2338875,MXU RES+COM,CONDO/APT
325754,78558,247196,1235977,42.349847,-71.091522,1050000,CONDOMINIUM,MID-RISE
581705,99590,482115,1735611,42.336723,-71.085306,1350000,MXU RES+COM,RAISED CAPE
565769,88481,477288,1590961,42.336723,-71.085306,1200000,MXU RES+COM,RAISED CAPE
768741,185388,583353,2916762,42.355538,-71.058125,2200000,OTHER EXEMPT,CONDO/APT
140278,33829,106449,532241,42.353487,-71.076713,375000,CONDOMINIUM,ROW-MIDDLE
145279,35035,110244,551219,42.369355,-71.036749,422000,3-FAM RES,DECKER
38352,9248,29104,145516,42.373991,-71.063299,107500,CONDOMINIUM,LOW-RISE
133975,32309,101666,508327,42.380815,-71.068293,307500,2-FAM RES,CONVENTIONAL
784912,189288,595624,2978116,42.344601,-71.073723,2500000,1-FAM RES,ROW-MIDDLE
22286,14687,7599,192458,42.289361,-71.065918,135600,CONDOMINIUM,LOW-RISE
74815,18042,56773,283862,42.323968,-71.077225,200000,3-FAM RES,CONVENTIONAL
231324,21509,209815,480543,42.287885,-71.142658,355000,1-FAM RES,DUPLEX
297442,71730,225712,1128558,42.376702,-71.035848,930625,2-FAM RES,ROW-MIDDLE
1038752,250504,788248,3941239,42.345411,-71.074062,3250000,2-FAM RES,ROW-MIDDLE
194965,47017,147948,739740,42.355225,-71.072979,610000,CONDOMINIUM,ROW-MIDDLE
159255,38405,120850,604249,42.355225,-71.072979,470000,CONDOMINIUM,ROW-MIDDLE
341266,82299,258967,1294833,42.30283,-71.071502,1100000,2-FAM RES,CONVENTIONAL
219053,52826,166227,831136,42.361777,-71.130991,614000,3-FAM RES,CONVENTIONAL
962603,232140,730463,3652312,42.359429,-71.068358,3102750,1-FAM RES,ROW-MIDDLE
195343,186910,8433,2360988,42.365532,-71.058281,2100000,MXU RES+COM,RAISED CAPE
438696,105795,332901,1664504,42.358923,-71.069723,1177465,9 + UNIT APT,CONDO/APT
1390969,335444,1055525,5277622,42.344588,-71.144269,4250000,OTHER EXEMPT,CONDO/APT
668174,37575,630599,1103547,42.35373,-71.075118,910000,CONDOMINIUM,ROW-MIDDLE
106894,57222,49672,769912,42.275251,-71.061971,620000,1-FAM RES,COLONIAL
195453,47135,148318,741586,42.263422,-71.121353,630000,2-FAM RES,TWO FAMILY
199070,48007,151063,755312,42.385848,-71.004726,587500,3-FAM RES,DECKER
194834,46985,147849,739241,42.385799,-71.0046,575000,3-FAM RES,DECKER
144347,34810,109537,547681,42.376874,-71.050834,426000,CONDOMINIUM,LOW-RISE
244460,58953,185507,927531,42.371652,-71.035688,825000,3-FAM RES,ROW-MIDDLE
771789,186123,585666,2928326,42.356571,-71.071501,2280000,1-FAM RES,ROW-MIDDLE
61899,14927,46972,234857,42.30884,-71.077823,173500,2-FAM RES,CONVENTIONAL
132493,31951,100542,502706,42.340324,-71.14184,422000,CONDOMINIUM,LOW-RISE
92073,22204,69869,349344,42.368599,-71.036982,272000,1-FAM RES,CONVENTIONAL
481190,116043,365147,1825734,42.379919,-71.067716,1440000,1-FAM RES,CONDO/APT
186086,44876,141210,706047,42.299758,-71.081728,628000,3-FAM RES,CONVENTIONAL
175098,42226,132872,664359,42.325182,-71.075599,535000,1-FAM RES,SEMI DETACHD
275753,66500,209253,1046263,42.353476,-71.146211,650000,3-FAM RES,DECKER
645782,155736,490046,2450229,42.365766,-71.05655,1810100,9 + UNIT APT,CONDO/APT
46609,19611,26998,273840,42.373991,-71.063299,213000,CONDOMINIUM,LOW-RISE
1005821,242562,763259,3816292,42.348253,-71.061579,3010000,MXU RES+COM,CONDO/APT
651301,157067,494234,2471169,42.366725,-71.036782,1990000,1-FAM RES,CONDO/APT
367559,88640,278919,1394592,42.385755,-71.004477,1150000,3-FAM RES,DECKER
6271,1512,4759,23795,42.336205,-71.086256,18768,MXU RES+COM,CONDO/APT
294729,71076,223653,1118265,42.27467,-71.070025,950000,4-8 UNIT APT,CONDO/APT
98412,27979,70432,352164,42.311726,-71.090323,240000,2-FAM RES,CONVENTIONAL
95885,23123,72762,363806,42.342918,-71.097177,300000,CONDOMINIUM,LOW-RISE
391068,94309,296759,1483791,42.358921,-71.069833,1049629,9 + UNIT APT,CONDO/APT
201657,48631,153026,765128,42.377641,-71.035629,650000,2-FAM RES,CONVENTIONAL
142046,97374,44672,1270287,42.303648,-71.105713,972500,3-FAM RES,DECKER
423553,102143,321410,1607047,42.31806,-71.09039,1250000,4-8 UNIT APT,CONDO/APT
456565,110104,346461,1732302,42.374822,-71.063094,1395000,MXU RES+COM,SEMI DETACHD
7451,1796,5655,28272,42.373082,-71.036218,20000,LIVE THEATRE,RAISED CAPE
471270,133985,337285,2023704,42.330186,-71.037135,1800000,3-FAM RES,SEMI DETACHD
223668,53939,169729,848645,42.305178,-71.061291,660757,4-8 UNIT APT,CONDO/APT
392456,94644,297812,1489058,42.325928,-71.058719,1250000,3-FAM RES,DECKER
59491,14346,45145,225722,42.372633,-71.03575,145000,4-8 UNIT APT,CONDO/APT
237189,57200,179989,899946,42.335269,-71.045931,700000,RETAIL STORE,RAISED CAPE
1439207,488268,950939,7096555,42.36288,-71.053893,5000000,9 + UNIT APT,CONDO/APT
321088,77433,243655,1218278,42.362241,-71.054721,900000,MXU RES+COM,RAISED CAPE
157242,37920,119322,596610,42.325256,-71.071935,450000,4-8 UNIT APT,CONDO/APT
277055,66814,210241,1051201,42.386248,-71.005212,935000,2-FAM RES,TWO FAMILY
735003,177252,557751,2788754,42.345374,-71.074203,2135000,1-FAM RES,ROW-MIDDLE
243034,58524,184510,921132,42.355142,-71.073285,649000,CONDOMINIUM,ROW-MIDDLE
210263,77249,133014,1105316,42.280706,-71.07874,939000,3-FAM RES,DECKER
97242,23450,73792,368958,42.288325,-71.0587,261000,3-FAM RES,DECKER
120552,29072,91480,457401,42.28229,-71.070713,345000,3-FAM RES,DECKER
291627,70328,221299,1106493,42.317364,-71.089936,940000,3-FAM RES,ROW-MIDDLE
335061,80803,254258,1271290,42.372672,-71.040425,1080000,MXU RES+COM,RAISED CAPE
71074,17140,53934,269669,42.324972,-71.077062,190000,MEDICAL OFFC,CONDO/APT
5177,1248,3929,19645,42.265277,-71.166497,14063,1-FAM RES,RANCH
65168,15715,49453,247261,42.347058,-71.088989,177000,CONDOMINIUM,LOW-RISE
69218,16692,52526,262628,42.347058,-71.088989,188000,CONDOMINIUM,LOW-RISE
79181,19095,60086,300427,42.347058,-71.088989,230000,CONDOMINIUM,LOW-RISE
20491,4941,15550,77749,42.28694,-71.090328,55000,CONDOMINIUM,FREE-STANDNG
22552,6411,16140,80704,42.28694,-71.090328,55000,CONDOMINIUM,FREE-STANDNG
743759,179364,564395,2821975,42.351787,-71.067367,2195000,CONDOMINIUM,HIGH-RISE
793804,191433,602371,3011855,42.360257,-71.067722,2225000,4-8 UNIT APT,CONDO/APT
166296,40103,126193,630961,42.309789,-71.061777,430000,3-FAM RES,DECKER
460709,111104,349605,1748024,42.360642,-71.067809,1485000,1-FAM RES,ROW-MIDDLE
279217,67335,211882,1059409,42.302969,-71.131745,900000,1-FAM RES,COLONIAL
417700,100732,316968,1584839,42.35206,-71.170505,1250000,3-FAM RES,DECKER
211926,51107,160819,804091,42.333452,-71.037269,675000,1-FAM RES,ROW-MIDDLE
1503719,362635,1141084,5705420,42.346266,-71.08654,4500000,9 + UNIT APT,CONDO/APT
162684,39232,123452,617257,42.382854,-71.07825,365000,3-FAM RES,DECKER
355369,85700,269669,1348345,42.332439,-71.100193,950000,3-FAM RES,DECKER
74,17,57,282,42.341056,-71.078459,200,4-8 UNIT APT,CONDO/APT
287654,69370,218284,1091420,42.288153,-71.129974,900000,1-FAM RES,CONDO/APT
184703,35550,149153,596610,42.318962,-71.060422,450000,3-FAM RES,DECKER
257520,62103,195417,977084,42.389829,-70.999312,760000,3-FAM RES,DECKER
110668,59243,51425,797095,42.288137,-71.053954,620000,3-FAM RES,DECKER
128651,31025,97626,488130,42.280908,-71.141861,385000,1-FAM RES,COLONIAL
170952,41226,129726,648628,42.294807,-71.057495,430000,CONDOMINIUM,DECKER
345361,83286,262075,1310371,42.351046,-71.084946,1100000,CONDOMINIUM,ROW-MIDDLE
274921,66299,208622,1043106,42.340246,-71.160422,840000,1-FAM RES,TUDOR
1236392,298167,938225,4691123,42.335651,-71.083973,3700000,3-FAM RES,ROW-MIDDLE
54215,13074,41141,205702,42.301936,-71.081498,160000,RES UDV LAND,DECKER
110013,26530,83483,417414,42.293276,-71.079965,325000,3-FAM RES,DECKER
359375,69170,290205,1160819,42.309172,-71.064686,1032500,3-FAM RES,DECKER
370335,89309,281026,1405131,42.351084,-71.086933,850000,BOARDING HSE,CONDO/APT
162645,39223,123422,617106,42.326833,-71.095806,480000,1-FAM RES,ROW-MIDDLE
37408,9021,28387,141931,42.305179,-71.059232,100000,1-FAM RES,CONVENTIONAL
165561,39926,125635,628176,42.283527,-71.09001,380000,3-FAM RES,SEMI DETACHD
52971,40292,12679,519827,42.312086,-71.07523,410000,3-FAM RES,DECKER
757381,182649,574732,2873657,42.334489,-71.078921,2200000,OTHER EXEMPT,CONDO/APT
480875,115967,364908,1824537,42.33443,-71.045703,1550000,1-FAM RES,SEMI DETACHD
193479,46659,146820,734097,42.344604,-71.094755,579000,CONDOMINIUM,MID-RISE
1207629,203143,1004486,3561358,42.332769,-71.109697,1950000,9 + UNIT APT,CONDO/APT
271462,65465,205997,1029981,42.32173,-71.104274,875000,3-FAM RES,DECKER
31438,7581,23857,119281,42.254769,-71.127649,101333,1-FAM RES,COLONIAL
1015511,244899,770612,3853060,42.341386,-71.077706,3000000,1-FAM RES,ROW-MIDDLE
352432,41803,310629,836795,42.333676,-71.053209,660000,1-FAM RES,CONVENTIONAL
45719,11025,34694,173470,42.283918,-71.129167,115000,2-FAM RES,CONVENTIONAL
760093,183303,576790,2883946,42.287355,-71.128499,2450000,4-8 UNIT APT,CONDO/APT
497396,182097,315299,2607281,42.329627,-71.035861,2150000,3-FAM RES,DECKER
260531,62829,197702,988509,42.374322,-71.064139,635000,CONDOMINIUM,ROW-MIDDLE
18409,4439,13970,69847,42.315107,-71.086872,50000,RES DEV LAND,DECKER
2198006,377022,1820984,6566399,42.342818,-71.057186,4475000,MXU RES+COM,CONDO/APT
516396,124533,391863,1959312,42.33597,-71.073825,1500000,CONDOMINIUM,ROW-MIDDLE
137853,33244,104609,523044,42.330086,-71.069835,370000,4-8 UNIT APT,ROW-MIDDLE
874777,177785,696992,2934703,42.359661,-71.068441,2000000,9 + UNIT APT,CONDO/APT
96906,23369,73537,367682,42.276794,-71.164353,290000,CONDOMINIUM,LOW-RISE
84710,20428,64282,321409,42.276726,-71.164281,250000,CONDOMINIUM,LOW-RISE
52414,12640,39774,198870,42.340925,-71.051061,150000,RES DEV LAND,CONVENTIONAL
238174,45842,192332,769327,42.317479,-71.089635,599000,3-FAM RES,SEMI DETACHD
169082,40775,128307,641531,42.376369,-71.031993,545000,3-FAM RES,DECKER
201281,48540,152741,763703,42.33465,-71.031155,615000,CONDOMINIUM,FREE-STANDNG
240984,58115,182869,914345,42.372804,-71.037339,700000,3-FAM RES,DECKER
642179,154867,487312,2436557,42.342403,-71.076918,1800000,3-FAM RES,ROW-MIDDLE
2173877,776917,1396960,11175677,42.342973,-71.099706,8000000,SUBSDZ HSNG,CONDO/APT
926887,223527,703360,3516798,42.344523,-71.081239,2900000,3-FAM RES,ROW-MIDDLE
565385,55494,509891,1208370,42.351007,-71.065413,865000,CONDOMINIUM,HIGH-RISE
681385,164322,517063,2585312,42.351007,-71.065413,1950000,CONDOMINIUM,HIGH-RISE
97355,40583,56772,567582,42.340289,-71.066838,399900,CONDOMINIUM,ROW-MIDDLE
187965,36064,151901,605835,42.340289,-71.066838,343000,CONDOMINIUM,ROW-MIDDLE
433333,83405,349928,1399714,42.361722,-71.139992,1175000,2-FAM RES,DUPLEX
96684,23316,73368,366837,42.273708,-71.069266,250000,1-FAM RES,CAPE COD
198490,47867,150623,753115,42.346649,-71.090327,594000,CONDOMINIUM,MID-RISE
285876,95695,190181,1394658,42.381871,-71.034744,1100000,2-FAM RES,TWO FAMILY
241034,58127,182907,914531,42.28225,-71.070833,736460,CONDOMINIUM,DECKER
241034,58127,182907,914531,42.28225,-71.070833,736460,CONDOMINIUM,DECKER
241034,58127,182907,914531,42.28225,-71.070833,736460,CONDOMINIUM,DECKER
1682105,0,1682105,1682106,42.332029,-71.044134,1429000,2-FAM RES,TWO FAMILY
294112,56608,237504,950016,42.283898,-71.134673,845000,1-FAM RES,COLONIAL
75037,18095,56942,284707,42.265635,-71.158932,239000,CONDOMINIUM,LOW-RISE
0,0,0,1,42.346668,-71.090363,1,CONDOMINIUM,MID-RISE
0,0,0,1,42.346668,-71.090363,1,CONDOMINIUM,MID-RISE
0,0,0,1,42.346668,-71.090363,1,CONDOMINIUM,MID-RISE
0,0,0,1,42.346668,-71.090363,1,CONDOMINIUM,MID-RISE
0,0,0,1,42.346668,-71.090363,1,CONDOMINIUM,MID-RISE
0,0,0,1,42.346668,-71.090363,1,CONDOMINIUM,MID-RISE
0,0,0,1,42.346668,-71.090363,1,CONDOMINIUM,MID-RISE
0,0,0,1,42.346668,-71.090363,1,CONDOMINIUM,MID-RISE
0,0,0,1,42.346668,-71.090363,1,CONDOMINIUM,MID-RISE
0,0,0,1,42.346668,-71.090363,1,CONDOMINIUM,MID-RISE
207750,50100,157650,788247,42.384772,-71.001191,650000,2-FAM RES,TWO FAMILY
604483,145776,458707,2293531,42.305029,-71.061227,2040000,4-8 UNIT APT,CONDO/APT
84818,20454,64364,321817,42.31107,-71.105419,246375,CONDOMINIUM,DECKER
97864,23600,74264,371318,42.31107,-71.105419,284272,CONDOMINIUM,DECKER
97892,23607,74285,371425,42.31107,-71.105419,284354,CONDOMINIUM,DECKER
2208874,107515,2101359,3454615,42.359064,-71.070873,2900000,3-FAM RES,ROW-MIDDLE
541516,104227,437289,1749158,42.330744,-71.104406,1232400,<BLANK>,DECKER
180251,34657,145594,581814,42.318578,-71.060517,517500,CONDOMINIUM,DECKER
513346,123798,389548,1947741,42.330744,-71.104406,1515000,3-FAM RES,DECKER
575457,138776,436681,2183401,42.359249,-71.068572,1700000,9 + UNIT APT,CONDO/APT
132003,31833,100170,500847,42.334466,-71.03127,370000,CONDOMINIUM,FREE-STANDNG
1262321,168535,1093786,3215068,42.342439,-71.076956,2425000,9 + UNIT APT,CONDO/APT
237052,57167,179885,899423,42.312504,-71.058039,800000,2-FAM RES,TWO FAMILY
1125997,271544,854453,4272264,42.312813,-71.05764,3800000,1-FAM RES,COLONIAL
149086,35953,113133,565664,42.312813,-71.05764,375000,1-FAM RES,COLONIAL
775605,187044,588561,2942802,42.345337,-71.074345,2500000,3-FAM RES,ROW-MIDDLE
80835,22982,57853,289268,42.281814,-71.08297,225000,2-FAM RES,CONVENTIONAL
98213,91467,6746,1158008,42.28221,-71.070953,1030000,3-FAM RES,DECKER
427326,103053,324273,1621365,42.342947,-71.066904,1337000,CONDOMINIUM,ROW-END
334542,42851,291691,831047,42.340261,-71.082038,706000,CONDOMINIUM,ROW-END
218335,52653,165682,828408,42.345169,-71.07426,645000,CONDOMINIUM,ROW-MIDDLE
13922,3357,10565,52824,42.318894,-71.105281,36000,CONDOMINIUM,FREE-STANDNG
27458,6621,20837,104181,42.318894,-71.105281,71000,CONDOMINIUM,FREE-STANDNG
35966,8673,27293,136463,42.318894,-71.105281,93000,CONDOMINIUM,FREE-STANDNG
168689,40680,128009,640041,42.367108,-71.033587,490000,3-FAM RES,DECKER
282568,68143,214425,1072121,42.382049,-71.034455,900000,3-FAM RES,DECKER
138926,33503,105423,527111,42.389232,-71.007798,410000,2-FAM RES,CONVENTIONAL
457606,110355,347251,1736253,42.366078,-71.056858,1475000,4-8 UNIT APT,CONDO/APT
76163,18367,57796,288979,42.277067,-71.086026,225000,2-FAM RES,TWO FAMILY
12417459,1148148,11269311,25720544,42.342617,-71.089809,19400000,4-8 UNIT APT,CONDO/APT
287728,69388,218340,1091700,42.331715,-71.096694,850000,MXU COM+RES,RAISED CAPE
148506,35813,112693,563465,42.272464,-71.069516,425000,MXU COM+RES,RAISED CAPE
155120,37408,117712,588560,42.304828,-71.061397,500000,1-FAM RES,COLONIAL
257500,62098,195402,977010,42.304828,-71.061397,830000,1-FAM RES,COLONIAL
466696,112548,354148,1770740,42.286166,-71.13933,1575000,MXU COM+RES,RAISED CAPE
389280,93878,295402,1477006,42.33213,-71.044258,1150000,3-FAM RES,DECKER
219591,42265,177326,709303,42.290701,-71.153417,535000,2-FAM RES,CONVENTIONAL
3224668,309186,2915482,6807073,42.351352,-71.083959,5300000,CONDOMINIUM,ROW-MIDDLE
3224668,309186,2915482,6807073,42.351352,-71.083959,5300000,CONDOMINIUM,ROW-MIDDLE
3224668,309186,2915482,6807073,42.351352,-71.083959,5300000,CONDOMINIUM,ROW-MIDDLE
3224668,309186,2915482,6807073,42.351352,-71.083959,5300000,CONDOMINIUM,ROW-MIDDLE
3224668,309186,2915482,6807073,42.351352,-71.083959,5300000,CONDOMINIUM,ROW-MIDDLE
3224668,309186,2915482,6807073,42.351352,-71.083959,5300000,CONDOMINIUM,ROW-MIDDLE
3224668,309186,2915482,6807073,42.351352,-71.083959,5300000,CONDOMINIUM,ROW-MIDDLE
3224668,309186,2915482,6807073,42.351352,-71.083959,5300000,CONDOMINIUM,ROW-MIDDLE
3224668,309186,2915482,6807073,42.351352,-71.083959,5300000,CONDOMINIUM,ROW-MIDDLE
240595,58021,182574,912867,42.37651,-71.03481,720000,3-FAM RES,DECKER
143122,34515,108607,543037,42.37651,-71.03481,360000,3-FAM RES,DECKER
476208,203010,273198,2828403,42.33515,-71.046205,2200000,MXU RES+COM,CONDO/APT
83792,20207,63585,317925,42.317051,-71.089674,224000,3-FAM RES,CONVENTIONAL
488252,66370,421882,1257263,42.311649,-71.089662,900000,9 + UNIT APT,CONDO/APT
273271,65901,207370,1036849,42.373172,-71.039357,855000,3-FAM RES,ROW-MIDDLE
231898,55924,175974,879868,42.330747,-71.034502,650000,3-FAM RES,SEMI DETACHD
135536,32685,102851,514255,42.334969,-71.047818,400000,1-FAM RES,SEMI DETACHD
160788,38775,122013,610067,42.335391,-71.047679,475000,1-FAM RES,CONVENTIONAL
135739,32734,103005,515025,42.343359,-71.104849,401000,CONDOMINIUM,MID-RISE
214143,51642,162501,812501,42.341338,-71.054575,670000,CONDOMINIUM,ROW-END
276115,66587,209528,1047637,42.389253,-71.005192,890000,3-FAM RES,CONVENTIONAL
290076,69954,220122,1100608,42.389303,-71.005579,935000,3-FAM RES,SEMI DETACHD
204687,38855,165832,654893,42.275757,-71.073613,582500,1-FAM RES,COLONIAL
160737,38763,121974,609868,42.350721,-71.128334,460000,CONDOMINIUM,LOW-RISE
2708032,653066,2054966,10274828,42.352391,-71.077438,8000000,CONDOMINIUM,LOW-RISE
1550138,373829,1176309,5881541,42.352391,-71.077438,4850000,CONDOMINIUM,LOW-RISE
208279,50228,158051,790255,42.318003,-71.090068,605000,3-FAM RES,ROW-END
1334398,321802,1012596,5062976,42.345126,-71.074423,4175000,2-FAM RES,ROW-MIDDLE
1104202,136038,968164,2680420,42.359129,-71.070756,1585000,MXU RES+COM,CONDO/APT
114906,83861,31045,1086569,42.314097,-71.089275,875000,3-FAM RES,DECKER
104559,25215,79344,396719,42.314097,-71.089275,263000,3-FAM RES,DECKER
567319,136814,430505,2152523,42.368453,-71.034417,1775000,9 + UNIT APT,CONDO/APT
1403844,338549,1065295,5326473,42.344261,-71.081568,4525000,4-8 UNIT APT,CONDO/APT
617221,148848,468373,2341863,42.344455,-71.074261,1650000,OTHER EXEMPT,ROW-MIDDLE
760093,183303,576790,2883946,42.385309,-71.016001,2450000,RES DEV LAND,CONDO/APT
760093,183303,576790,2883946,42.385285,-71.016315,2450000,1-FAM RES,COLONIAL
118526,28583,89943,449711,42.305271,-71.066814,400000,2-FAM RES,CONVENTIONAL
470947,113573,357374,1786869,42.355351,-71.131017,1500000,4-8 UNIT APT,CONDO/APT
378690,91324,287366,1436828,42.35455,-71.075815,1100000,CONDOMINIUM,HIGH-RISE
917402,143473,773929,2579761,42.35455,-71.075815,1975000,CONDOMINIUM,HIGH-RISE
962638,233084,729554,3663291,42.297938,-71.087457,2950000,9 + UNIT APT,CONDO/APT
1530571,294594,1235977,4943908,42.297938,-71.087457,4200000,9 + UNIT APT,CONDO/APT
230182,55510,174672,873360,42.301838,-71.060927,680000,4-8 UNIT APT,CONDO/APT
220329,53134,167195,835971,42.375105,-71.064878,639999,MXU RES+COM,DECKER
139769,60060,79709,835664,42.342809,-71.068745,650000,CONDOMINIUM,ROW-MIDDLE
94189,22714,71475,357373,42.319576,-71.063854,300000,3-FAM RES,DECKER
115474,27847,87627,438134,42.374972,-71.036005,255000,4-8 UNIT APT,CONDO/APT
146959,35440,111519,557593,42.308616,-71.063269,380000,3-FAM RES,DECKER
119295,28769,90526,452630,42.274566,-71.167456,357000,1-FAM RES,COLONIAL
630449,121344,509105,2036419,42.314868,-71.101135,1730000,3-FAM RES,DECKER
432659,71871,360788,1265405,42.254216,-71.124661,1075000,4-8 UNIT APT,CONDO/APT
342006,35491,306515,753232,42.254274,-71.124778,632306,MXU RES+COM,RAISED CAPE
129757,55249,74508,769912,42.295561,-71.074375,620000,3-FAM RES,DECKER
410555,69062,341493,1210748,42.322819,-71.102741,975000,3-FAM RES,DECKER
1275423,295767,979656,4702349,42.367416,-71.054418,3600000,9 + UNIT APT,CONDO/APT
189345,45662,143683,718414,42.306441,-71.062844,550000,3-FAM RES,DECKER
235078,157547,77531,2060515,42.360748,-71.068599,1475000,MXU RES+COM,CONDO/APT
4303301,1037780,3265521,16327601,42.346305,-71.088654,12500000,INN/RESORT,CONDO/APT
487133,117476,369657,1848284,42.351148,-71.086705,1415000,CONDOMINIUM,ROW-END
324410,78234,246176,1230879,42.317206,-71.059404,1015000,2-FAM RES,CONVENTIONAL
298514,66299,232215,1066700,42.335198,-71.047357,859000,CONDOMINIUM,FREE-STANDNG
44926,27024,17902,358042,42.286167,-71.082814,230000,CONDOMINIUM,ROW-END
11222,2706,8516,42579,42.292456,-71.071212,30000,CONDOMINIUM,ROW-END
14963,3608,11355,56772,42.292456,-71.071212,40000,CONDOMINIUM,ROW-END
12766,3078,9688,48438,42.292456,-71.071212,34128,CONDOMINIUM,ROW-END
44682,10775,33907,169534,42.292456,-71.071212,132000,CONDOMINIUM,ROW-END
16729,4034,12695,63472,42.292456,-71.071212,44900,CONDOMINIUM,ROW-END
1269389,306124,963265,4816325,42.354436,-71.072539,3750000,CONDOMINIUM,ROW-MIDDLE
147396,35546,111850,559252,42.310175,-71.062426,435000,3-FAM RES,DECKER
189641,45733,143908,719539,42.311629,-71.077927,640000,3-FAM RES,CONVENTIONAL
94568,26886,67682,338410,42.300491,-71.073515,250000,2-FAM RES,CONVENTIONAL
73380,17696,55684,278418,42.271657,-71.110262,210000,2-FAM RES,TWO FAMILY
61823,25775,36048,360476,42.291797,-71.054238,255000,1-FAM RES,COLONIAL
251606,60677,190929,954645,42.312811,-71.05922,811000,1-FAM RES,RANCH
42846,10332,32514,162567,42.282375,-71.08857,115000,3-FAM RES,DECKER
206721,46380,160341,744106,42.357897,-71.066019,478000,CONDOMINIUM,ROW-END
172092,41501,130591,652953,42.283473,-71.159276,515000,1-FAM RES,COLONIAL
55713,13435,42278,211389,42.283781,-71.0869,125000,3-FAM RES,DECKER
768887,147990,620897,2483587,42.33802,-71.150876,2000000,4-8 UNIT APT,CONDO/APT
819182,60293,758889,1517778,42.295546,-71.115762,1350000,MXU RES+COM,RAISED CAPE
154382,37230,117152,585756,42.349497,-71.067479,462000,CONDOMINIUM,ROW-MIDDLE
1590236,177691,1412545,3649075,42.345105,-71.074505,3100000,4-8 UNIT APT,CONDO/APT
718221,173205,545016,2725077,42.359312,-71.070894,1920000,MXU RES+COM,CONDO/APT
155049,37391,117658,588290,42.362133,-71.052603,390000,CONDOMINIUM,ROW-END
55886,13477,42409,212045,42.379662,-71.06228,150000,1-FAM RES,SEMI DETACHD
321502,77533,243969,1219843,42.348404,-71.106001,1085000,CONDOMINIUM,MID-RISE
1218712,293903,924809,4624044,42.364748,-71.05556,3416000,MXU RES+COM,CONDO/APT
108922,26267,82655,413273,42.311286,-71.052886,250000,RETAIL STORE,CONDO/APT
110454,26637,83817,419087,42.305552,-71.08301,300000,3-FAM RES,CONVENTIONAL
168899,40731,128168,640839,42.38353,-71.000021,570000,1-FAM RES,CAPE COD
701380,169144,532236,2661180,42.362941,-71.052695,2072000,CONDOMINIUM,ROW-MIDDLE
987080,427856,559224,5944461,42.352009,-71.069917,5050000,CONDOMINIUM,HIGH-RISE
340762,82177,258585,1292922,42.383359,-70.997891,1150000,1-FAM RES,BNGL/COTTAGE
1523268,367349,1155919,5779591,42.351851,-71.070215,4500000,CONDOMINIUM,HIGH-RISE
275411,66417,208994,1044966,42.368521,-71.034335,800000,3-FAM RES,ROW-END
736365,177581,558784,2793919,42.342649,-71.076867,2000000,3-FAM RES,ROW-MIDDLE
681524,164355,517169,2585844,42.344436,-71.074328,2300000,2-FAM RES,ROW-MIDDLE
265726,64082,201644,1008217,42.355004,-71.073793,785000,CONDOMINIUM,ROW-MIDDLE
126939,30612,96327,481632,42.351635,-71.173772,375000,CONDOMINIUM,MID-RISE
1096164,171430,924734,3082448,42.352354,-71.068329,2400000,CONDOMINIUM,HIGH-RISE
398510,77155,321355,1292479,42.350971,-71.043923,1098000,CONDOMINIUM,HIGH-RISE
240984,58115,182869,914345,42.351809,-71.15866,700000,2-FAM RES,CONVENTIONAL
517319,119845,397474,1905911,42.337408,-71.150625,1263500,4-8 UNIT APT,CONDO/APT
685050,72947,612103,1530257,42.325096,-71.059214,1300000,3-FAM RES,DECKER
274462,52407,222055,881690,42.325096,-71.059214,675000,3-FAM RES,DECKER
166033,40040,125993,629962,42.28736,-71.078181,490000,2-FAM RES,CONVENTIONAL
510504,392792,117712,5061620,42.356057,-71.059157,4300000,CONDOMINIUM,HIGH-RISE
135335,32637,102698,513487,42.303351,-71.164899,405000,CONDOMINIUM,MID-RISE
248194,59854,188340,941696,42.336241,-71.048438,800000,1-FAM RES,ROW-MIDDLE
413522,99724,313798,1568990,42.306902,-71.068081,1237500,WAREHOUSE,CONDO/APT
121456,34531,86925,434627,42.320372,-71.063682,350000,CONDOMINIUM,DECKER
1085062,261672,823390,4116948,42.34269,-71.076909,3456000,2-FAM RES,ROW-MIDDLE
27931,6735,21196,105977,42.298364,-71.07826,60000,2-FAM RES,CONVENTIONAL
212736,51303,161433,807165,42.291585,-71.066754,650000,2-FAM RES,CONDO/APT
323384,46760,276624,865184,42.27522,-71.062561,735000,CONDOMINIUM,FREE-STANDNG
15902,3834,12068,60337,42.271703,-71.068044,40000,CONDOMINIUM,MID-RISE
171788,41428,130360,651797,42.282081,-71.091935,499000,3-FAM RES,DECKER
1023392,592507,430885,7888517,42.349536,-71.131955,5950000,MXU RES+COM,CONDO/APT
576556,139041,437515,2187572,42.340717,-71.147613,1650000,4-8 UNIT APT,CONDO/APT
171116,41266,129850,649247,42.28193,-71.091985,505000,3-FAM RES,DECKER
330407,79680,250727,1253634,42.280535,-71.081559,1065000,3-FAM RES,DECKER
44595,10754,33841,169205,42.31148,-71.089274,125000,4-8 UNIT APT,CONDO/APT
570614,60761,509853,1274633,42.377852,-71.059253,1070000,CONDOMINIUM,FREE-STANDNG
281574,54195,227379,909516,42.385263,-71.016214,750000,1-FAM RES,COLONIAL
7735,1865,5870,29347,42.379118,-71.065956,20000,CTYMUNI PROP,SEMI DETACHD
51416,12399,39017,195081,42.377699,-71.031079,138000,3-FAM RES,SEMI DETACHD
415500,100201,315299,1576495,42.368657,-71.03417,1300000,3-FAM RES,SEMI DETACHD
287654,69370,218284,1091420,42.368657,-71.03417,900000,3-FAM RES,SEMI DETACHD
395903,95475,300428,1502139,42.336315,-71.04819,1150000,2-FAM RES,ROW-END
996827,134358,862469,2553586,42.342731,-71.076952,1510000,3-FAM RES,ROW-MIDDLE
148191,35737,112454,562268,42.376833,-71.035495,472000,1-FAM RES,ROW-MIDDLE
173853,41926,131927,659635,42.28146,-71.163767,505000,1-FAM RES,COLONIAL
834883,201339,633544,3167719,42.359413,-71.068846,2100000,4-8 UNIT APT,CONDO/APT
40499,9766,30733,153665,42.284294,-71.083575,110000,2-FAM RES,TWO FAMILY
199717,48163,151554,757768,42.336298,-71.05122,590000,2-FAM RES,CONVENTIONAL
238883,57608,181275,906374,42.336361,-71.039163,705000,2-FAM RES,SEMI DETACHD
73217,65510,7707,832261,42.373329,-71.039216,648000,4-8 UNIT APT,ROW-END
199007,38303,160704,642818,42.373329,-71.039216,500000,4-8 UNIT APT,ROW-END
89722,21637,68085,340423,42.34971,-71.132899,268500,CONDOMINIUM,LOW-RISE
198223,47803,150420,752098,42.352743,-71.158062,585000,1-FAM RES,COLONIAL
306115,73822,232293,1161465,42.320989,-71.064087,975000,1-FAM RES,CONVENTIONAL
214609,37905,176704,653805,42.349059,-71.13604,462500,CONDOMINIUM,TOWNHOUSE
197263,47571,149692,748457,42.342772,-71.076994,573000,CONDOMINIUM,ROW-MIDDLE
170381,41088,129293,646461,42.377083,-71.035089,575000,2-FAM RES,ROW-MIDDLE
345361,83286,262075,1310371,42.325334,-71.068497,1100000,3-FAM RES,DECKER
1682171,405670,1276501,6382501,42.354908,-71.074857,4100000,CONDOMINIUM,ROW-END
2268286,343693,1924593,6250513,42.354908,-71.074857,5310000,CONDOMINIUM,ROW-END
2438844,381412,2057432,6858107,42.3551,-71.073792,6100000,CONDOMINIUM,ROW-END
3588505,418035,3170470,8432100,42.3551,-71.073792,7500000,CONDOMINIUM,ROW-END
1446292,154007,1292285,3230712,42.354908,-71.074857,2436800,CONDOMINIUM,ROW-END
829682,200085,629597,3147984,42.344002,-71.081896,2800000,3-FAM RES,ROW-MIDDLE
261829,63142,198687,993434,42.371603,-71.035908,800000,3-FAM RES,CONVENTIONAL
141513,34127,107386,536929,42.339576,-71.067957,312500,CONDOMINIUM,MID-RISE
141513,34127,107386,536929,42.339576,-71.067957,312500,CONDOMINIUM,MID-RISE
141513,34127,107386,536929,42.339833,-71.068094,312500,CONDOMINIUM,MID-RISE
141513,34127,107386,536929,42.339576,-71.067957,312500,CONDOMINIUM,MID-RISE
93104,22452,70652,353256,42.354676,-71.075708,200000,CONDOMINIUM,MID-RISE
4949474,123680,4825794,6382501,42.3551,-71.073792,4100000,CONDOMINIUM,ROW-END
115238,51020,64218,706394,42.311876,-71.063205,550000,3-FAM RES,DECKER
260644,62856,197788,988939,42.378796,-71.032183,780000,3-FAM RES,SEMI DETACHD
691503,97943,593560,1826337,42.330821,-71.102948,1000000,4-8 UNIT APT,CONDO/APT
308111,74303,233808,1169039,42.354908,-71.074857,775000,CONDOMINIUM,ROW-END
2384981,293602,2091379,5786824,42.342255,-71.067594,4275000,CONDOMINIUM,MID-RISE
780579,188243,592336,2961677,42.342255,-71.067594,2385000,CONDOMINIUM,MID-RISE
113656,27409,86247,431234,42.327355,-71.094323,255000,3-FAM RES,SEMI DETACHD
268681,46610,222071,808738,42.284866,-71.153006,610000,2-FAM RES,TWO FAMILY
142138,53387,88751,760722,42.380036,-71.035245,600000,3-FAM RES,ROW-MIDDLE
214609,37905,176704,653805,42.349055,-71.136075,462500,CONDOMINIUM,TOWNHOUSE
204786,195154,9632,2465958,42.318156,-71.105403,1920000,4-8 UNIT APT,CONDO/APT
240504,20401,220103,476889,42.327895,-71.077495,325000,MXU RES+COM,CONDO/APT
153409,36995,116414,582066,42.342964,-71.100443,430000,CONDOMINIUM,MID-RISE
1255805,196396,1059409,3531363,42.360638,-71.06793,3000000,4-8 UNIT APT,CONDO/APT
275001,201464,73537,2609279,42.342638,-71.068648,2058000,1-FAM RES,ROW-MIDDLE
821811,198187,623624,3118122,42.356518,-71.070233,2125000,1-FAM RES,ROW-MIDDLE
81500,19654,61846,309229,42.32994,-71.092465,205000,3-FAM RES,CONVENTIONAL
108807,48173,60634,666978,42.264913,-71.109898,550000,4-8 UNIT APT,CONDO/APT
286410,55126,231284,925136,42.35062,-71.135905,745000,1-FAM RES,COLONIAL
1642980,396219,1246761,6233803,42.346065,-71.080032,5020000,4-8 UNIT APT,CONDO/APT
984664,237460,747204,3736016,42.346469,-71.088364,2209200,9 + UNIT APT,CONDO/APT
116955,28204,88751,443754,42.366865,-71.038638,350000,1-FAM RES,ROW-MIDDLE
1056486,254781,801705,4008522,42.351084,-71.086933,2575000,2-FAM RES,ROW-END
1963961,307145,1656816,5522720,42.351084,-71.086933,4300000,1-FAM RES,ROW-END
206487,39743,166744,666978,42.33246,-71.049811,550000,1-FAM RES,ROW-END
269054,64884,204170,1020846,42.328271,-71.090932,908000,3-FAM RES,DECKER
70507,17003,53504,267520,42.286863,-71.120462,211000,CONDOMINIUM,TOWNHOUSE
398140,96015,302125,1510624,42.372513,-71.061146,1175000,4-8 UNIT APT,ROW-END
110013,26530,83483,417414,42.318442,-71.066234,325000,3-FAM RES,SEMI DETACHD
371020,147497,223523,2080004,42.363997,-71.056058,1675000,4-8 UNIT APT,CONDO/APT
546007,131674,414333,2071662,42.350917,-71.084881,1613000,CONDOMINIUM,ROW-END
780202,188152,592050,2960247,42.351967,-71.082347,2485000,CONDOMINIUM,ROW-MIDDLE
270464,65224,205240,1026198,42.350917,-71.084881,799000,CONDOMINIUM,ROW-END
383539,92493,291046,1455226,42.34502,-71.074831,1200000,CONDOMINIUM,LOW-RISE
570434,86788,483646,1576019,42.325066,-71.0591,1323000,3-FAM RES,DECKER
459381,176299,283082,2502082,42.356484,-71.071955,1370000,9 + UNIT APT,ROW-MIDDLE
3319566,800543,2519023,12595112,42.351717,-71.077546,9500000,1-FAM RES,ROW-MIDDLE
2818184,41562,2776622,3299753,42.356484,-71.071955,2050000,9 + UNIT APT,ROW-MIDDLE
287654,69370,218284,1091420,42.366895,-71.033101,900000,3-FAM RES,DECKER
607446,146491,460955,2304774,42.327911,-71.104628,2050000,3-FAM RES,DECKER
140734,33939,106795,533971,42.36302,-71.052604,430000,CONDOMINIUM,MID-RISE
1053543,254071,799472,3997359,42.359231,-71.068863,2650000,9 + UNIT APT,CONDO/APT
220247,53114,167133,835664,42.293004,-71.081169,650000,4-8 UNIT APT,CONDO/APT
799407,91110,708297,1855062,42.293004,-71.081169,1650000,4-8 UNIT APT,CONDO/APT
128410,26886,101524,439934,42.291427,-71.053349,325000,2-FAM RES,CONVENTIONAL
204235,49253,154982,774908,42.330313,-71.039598,639000,CONDOMINIUM,MID-RISE
4391,1248,3143,15715,42.264798,-71.166678,11250,1-FAM RES,BI-LEVEL
682532,164598,517934,2589666,42.34195,-71.07702,2200000,4-8 UNIT APT,ROW-MIDDLE
67679,16321,51358,256786,42.341493,-71.097645,175000,CONDOMINIUM,MID-RISE
53113,12808,40305,201521,42.34855,-71.134012,152000,CONDOMINIUM,ROW-MIDDLE
2904175,700368,2203807,11019031,42.349248,-71.068952,9250000,PARKING LOT,ROW-MIDDLE
298215,57398,240817,963265,42.371683,-71.035814,750000,3-FAM RES,DECKER
498888,120311,378577,1892883,42.360679,-71.070868,1290000,CONDOMINIUM,ROW-MIDDLE
430200,103746,326454,1632266,42.345404,-71.106289,950000,4-8 UNIT APT,CONDO/APT
1893452,456623,1436829,7184144,42.348434,-71.134252,5500000,9 + UNIT APT,CONDO/APT
1109136,410656,698480,5867230,42.348566,-71.135303,4200000,CONDOMINIUM,ROW-END
1109136,410656,698480,5867230,42.348566,-71.135303,4200000,CONDOMINIUM,ROW-END
1109136,410656,698480,5867230,42.348566,-71.135303,4200000,CONDOMINIUM,ROW-END
1109136,410656,698480,5867230,42.348566,-71.135303,4200000,CONDOMINIUM,ROW-END
1109136,410656,698480,5867230,42.348566,-71.135303,4200000,CONDOMINIUM,ROW-END
1109136,410656,698480,5867230,42.348566,-71.135303,4200000,CONDOMINIUM,ROW-END
1109136,410656,698480,5867230,42.348566,-71.135303,4200000,CONDOMINIUM,ROW-END
1109136,410656,698480,5867230,42.348566,-71.135303,4200000,CONDOMINIUM,ROW-END
1109136,410656,698480,5867230,42.348566,-71.135303,4200000,CONDOMINIUM,ROW-END
1109136,410656,698480,5867230,42.348566,-71.135303,4200000,CONDOMINIUM,ROW-END
1109136,410656,698480,5867230,42.348566,-71.135303,4200000,CONDOMINIUM,ROW-END
1109136,410656,698480,5867230,42.348566,-71.135303,4200000,CONDOMINIUM,ROW-END
1109136,410656,698480,5867230,42.348566,-71.135303,4200000,CONDOMINIUM,ROW-END
1109136,410656,698480,5867230,42.348566,-71.135303,4200000,CONDOMINIUM,ROW-END
1109136,410656,698480,5867230,42.348566,-71.135303,4200000,CONDOMINIUM,ROW-END
1109136,410656,698480,5867230,42.348566,-71.135303,4200000,CONDOMINIUM,ROW-END
1109136,410656,698480,5867230,42.348566,-71.135303,4200000,CONDOMINIUM,ROW-END
1109136,410656,698480,5867230,42.348566,-71.135303,4200000,CONDOMINIUM,ROW-END
1109136,410656,698480,5867230,42.348566,-71.135303,4200000,CONDOMINIUM,ROW-END
1109136,410656,698480,5867230,42.348566,-71.135303,4200000,CONDOMINIUM,ROW-END
149133,35964,113169,565842,42.305179,-71.059232,475000,1-FAM RES,CONVENTIONAL
219775,53000,166775,833872,42.305213,-71.059132,700000,2-FAM RES,TWO FAMILY
103724,16221,87503,291676,42.330226,-71.039044,220000,CONDOMINIUM,DECKER
434338,104744,329594,1647969,42.391113,-71.01277,1400000,2-FAM RES,TWO FAMILY
195453,47135,148318,741586,42.391113,-71.01277,630000,2-FAM RES,TWO FAMILY
206558,49813,156745,783724,42.368928,-71.033841,600000,3-FAM RES,SEMI DETACHD
282612,54395,228217,912867,42.38006,-71.035183,720000,3-FAM RES,ROW-MIDDLE
172316,41555,130761,653805,42.349048,-71.136144,462500,CONDOMINIUM,TOWNHOUSE
186591,44998,141593,707964,42.348805,-71.090287,542000,CONDOMINIUM,MID-RISE
64252,40642,23610,535157,42.279589,-71.09744,476000,1-FAM RES,COLONIAL
233911,56409,177502,887509,42.372949,-71.036858,700000,3-FAM RES,ROW-MIDDLE
2019100,187454,1831646,4191053,42.332922,-71.101472,3375000,4-8 UNIT APT,CONDO/APT
307698,74204,233494,1167468,42.350971,-71.043923,991800,CONDOMINIUM,HIGH-RISE
60916,14690,46226,231129,42.30536,-71.065282,163500,2-FAM RES,CONVENTIONAL
680425,369976,310449,4967174,42.305562,-71.058771,4000000,MXU RES+COM,RAISED CAPE
680425,369976,310449,4967174,42.30533,-71.058825,4000000,COM PDV LAND,COLONIAL
495270,29598,465672,838210,42.305084,-71.058829,675000,COMM USE,COLONIAL
242192,58406,183786,918927,42.373224,-71.035067,740000,3-FAM RES,CONDO/APT
1482363,151098,1331265,3233071,42.339656,-71.065048,2550000,MXU RES+COM,RAISED CAPE
191048,36771,154277,617106,42.330421,-71.103241,480000,CONDOMINIUM,DECKER
123028,29669,93359,466794,42.286206,-71.156407,290000,CONDOMINIUM,LOW-RISE
214609,37905,176704,653805,42.349048,-71.136155,462500,CONDOMINIUM,TOWNHOUSE
990528,154909,835619,2785397,42.331214,-71.10561,1962500,4-8 UNIT APT,CONDO/APT
955241,183858,771383,3085531,42.331214,-71.10561,2400000,4-8 UNIT APT,CONDO/APT
26732,6446,20286,101429,42.294038,-71.051992,80000,CONDOMINIUM,LOW-RISE
264297,63737,200560,1002797,42.370123,-71.035849,780000,3-FAM RES,DECKER
1420912,49566,1371346,1995220,42.350971,-71.043923,1695000,CONDOMINIUM,HIGH-RISE
234990,56669,178321,891601,42.33547,-71.052865,672500,3-FAM RES,ROW-END
1255859,302861,952998,4764986,42.354815,-71.075197,4000000,CONDOMINIUM,ROW-MIDDLE
1155629,278690,876939,4384692,42.343121,-71.075338,3900000,2-FAM RES,ROW-END
574407,53237,521170,1191246,42.334804,-71.053388,1000000,1-FAM RES,ROW-END
102499,24718,77781,388905,42.379634,-71.03628,302500,CONDOMINIUM,ROW-END
164454,39659,124795,623975,42.289219,-71.166459,555000,1-FAM RES,RANCH
146951,35438,111513,557565,42.373597,-71.038943,449000,CONDOMINIUM,ROW-END
188160,45376,142784,713917,42.333404,-71.029296,635000,1-FAM RES,ROW-END
222914,53757,169157,845785,42.372998,-71.036802,710000,3-FAM RES,ROW-END
199992,47847,152145,754383,42.342964,-71.100443,595000,CONDOMINIUM,MID-RISE
747683,180310,567373,2836861,42.342337,-71.077549,2410000,1-FAM RES,ROW-MIDDLE
86964,29110,57854,424260,42.293725,-71.064877,330000,1-FAM RES,CONVENTIONAL
1176729,135278,1041451,2744139,42.348676,-71.137367,1660000,9 + UNIT APT,CONDO/APT
159775,38531,121244,606217,42.282798,-71.142105,515000,1-FAM RES,BNGL/COTTAGE
267328,64468,202860,1014297,42.335683,-71.054637,800000,1-FAM RES,CONDO/APT
336819,64904,271915,1088837,42.25445,-71.12852,925000,3-FAM RES,CONVENTIONAL
326737,81013,245724,1265405,42.303622,-71.070977,1075000,3-FAM RES,DECKER
590934,113739,477195,1908780,42.312437,-71.049112,1505500,2-FAM RES,CONVENTIONAL
508392,122603,385789,1928941,42.344265,-71.074954,1425000,3-FAM RES,ROW-MIDDLE
434408,104761,329647,1648232,42.352929,-71.131099,1300000,CONDOMINIUM,ROW-MIDDLE
434408,104761,329647,1648232,42.352929,-71.131099,1300000,CONDOMINIUM,ROW-MIDDLE
434408,104761,329647,1648232,42.352929,-71.131099,1300000,CONDOMINIUM,ROW-MIDDLE
434408,104761,329647,1648232,42.352929,-71.131099,1300000,CONDOMINIUM,ROW-MIDDLE
103414,24939,78475,392373,42.284566,-71.12936,349000,CONDOMINIUM,LOW-RISE
1784,430,1354,6768,42.271988,-71.171106,5000,1-FAM RES,COLONIAL
174886,42175,132711,663555,42.271988,-71.171106,475000,1-FAM RES,COLONIAL
205491,52389,153102,812501,42.303088,-71.076884,670000,4-8 UNIT APT,CONDO/APT
524142,126401,397741,1988701,42.359792,-71.071436,1500000,1-FAM RES,ROW-MIDDLE
4081718,123544,3958174,5513171,42.357601,-71.066855,3900000,4-8 UNIT APT,ROW-END
2210673,275788,1934885,5406107,42.350919,-71.085141,4205000,9 + UNIT APT,CONDO/APT
192605,46448,146157,730782,42.31815,-71.055378,650000,2-FAM RES,TWO FAMILY
86066,20755,65311,326552,42.271902,-71.129754,250000,2-FAM RES,TWO FAMILY
270011,65115,204896,1024479,42.351148,-71.086705,825000,CONDOMINIUM,ROW-END
258577,62358,196219,981092,42.351148,-71.086705,740000,CONDOMINIUM,ROW-END
1085846,261861,823985,4119924,42.344783,-71.077945,3500000,3-FAM RES,ROW-MIDDLE
66273,15982,50291,251452,42.330863,-71.057615,180000,1-FAM RES,ROW-END
126759,87884,38875,1145043,42.361042,-71.0693,810000,4-8 UNIT APT,CONDO/APT
63338,15274,48064,240317,42.320383,-71.090096,170000,2-FAM RES,CONVENTIONAL
153713,37069,116644,583220,42.28578,-71.138437,460000,1-FAM RES,COLONIAL
144008,34728,109280,546396,42.301812,-71.078142,425000,3-FAM RES,ROW-MIDDLE
141160,34042,107118,535590,42.301582,-71.070457,455000,1-FAM RES,COLONIAL
465750,112319,353431,1767153,42.332167,-71.109444,1265000,3-FAM RES,SEMI DETACHD
1387775,237815,1149960,4143237,42.314629,-71.057224,2450000,9 + UNIT APT,CONDO/APT
953887,230038,723849,3619243,42.358779,-71.06563,2550000,2-FAM RES,ROW-MIDDLE
215076,64656,150420,964228,42.284353,-71.122103,750000,3-FAM RES,CONVENTIONAL
62591,15094,47497,237483,42.329884,-71.055582,170000,2-FAM RES,CONVENTIONAL
381280,64622,316658,1130032,42.311308,-71.067334,910000,3-FAM RES,DECKER
208180,50204,157976,789877,42.305297,-71.107781,615000,2-FAM RES,CONVENTIONAL
120389,29032,91357,456782,42.358483,-71.13061,360275,CONDOMINIUM,FREE-STANDNG
1633921,255530,1378391,4594636,42.342427,-71.078887,3700000,1-FAM RES,ROW-MIDDLE
245812,38442,207370,691232,42.382703,-71.068034,570000,CONDOMINIUM,DECKER
74264,26886,47378,385788,42.354976,-71.150575,285000,1-FAM RES,COLONIAL
1533430,369800,1163630,5818149,42.377666,-71.037937,5175000,MXU RES+COM,CONDO/APT
1533430,369800,1163630,5818149,42.377702,-71.037838,5175000,MXU RES+COM,CONDO/APT
248194,59854,188340,941696,42.292391,-71.054821,800000,3-FAM RES,CONVENTIONAL
48920,11797,37123,185612,42.287632,-71.071609,140000,CONDOMINIUM,DECKER
97839,23594,74245,371224,42.287525,-71.071656,280000,CONDOMINIUM,DECKER
182314,47025,135289,727180,42.355172,-71.126212,430000,1-FAM RES,COLONIAL
2719686,655877,2063809,10319044,42.357908,-71.066022,7900000,1-FAM RES,ROW-END
186363,44943,141420,707100,42.317885,-71.059913,550000,3-FAM RES,CONVENTIONAL
351988,32692,319296,730782,42.375903,-71.064698,650000,CONDOMINIUM,ROW-END
207123,49949,157174,785871,42.306626,-71.085835,699000,2-FAM RES,CONVENTIONAL
458184,110495,347689,1738444,42.378396,-71.064741,1459349,4-8 UNIT APT,CONDO/APT
311513,75124,236389,1181945,42.378482,-71.064658,992192,3-FAM RES,ROW-MIDDLE
220535,53184,167351,836755,42.322048,-71.106204,690000,CONDOMINIUM,FREE-STANDNG
90713,21876,68837,344182,42.34642,-71.140593,242500,CONDOMINIUM,LOW-RISE
645026,124150,520876,2083504,42.287933,-71.084603,1770000,4-8 UNIT APT,CONDO/APT
262070,63200,198870,994350,42.287933,-71.084603,750000,4-8 UNIT APT,CONDO/APT
63288,26386,36902,369020,42.280661,-71.130817,260000,CONDOMINIUM,FREE-STANDNG
831001,200403,630598,3152991,42.356064,-71.131504,2600000,MXU COM+RES,CONDO/APT
372577,89850,282727,1413633,42.357419,-71.071997,1000000,CONDOMINIUM,LOW-RISE
176483,152229,24254,1940302,42.330579,-71.044009,1600000,1-FAM RES,DECKER
399331,113533,285798,1428993,42.352741,-71.158425,845000,1-FAM RES,COLONIAL
222236,53594,168642,843209,42.373905,-71.034121,750000,3-FAM RES,ROW-MIDDLE
94624,22819,71805,359021,42.340997,-71.153864,305000,CONDOMINIUM,ROW-END
154083,37158,116925,584625,42.378799,-71.066855,520000,CONDOMINIUM,ROW-END
562999,135772,427227,2136132,42.331275,-71.106222,1900000,3-FAM RES,CONVENTIONAL
767047,184980,582067,2910332,42.342154,-71.074431,2150000,2-FAM RES,ROW-MIDDLE
135837,32758,103079,515392,42.302947,-71.0596,425000,MXU RES+COM,CONDO/APT
51873,12509,39364,196818,42.348396,-71.139851,107767,CONDOMINIUM,LOW-RISE
969955,304881,665074,4502488,42.359534,-71.063389,3825000,MXU RES+COM,CONDO/APT
220027,53061,166966,834829,42.356246,-71.165506,650000,CONDOMINIUM,LOW-RISE
246674,47478,199196,796786,42.358048,-71.140624,610000,2-FAM RES,CONVENTIONAL
461528,111301,350227,1751132,42.366675,-71.057656,1470000,3-FAM RES,ROW-MIDDLE
567821,136935,430886,2154427,42.339725,-71.077354,1625000,BOARDING HSE,CONDO/APT
213184,51411,161773,808863,42.36246,-71.052338,667000,CONDOMINIUM,ROW-MIDDLE
241673,58281,183392,916958,42.324805,-71.059503,702000,3-FAM RES,DECKER
171826,41437,130389,651941,42.366594,-71.032885,525000,2-FAM RES,SEMI DETACHD
121379,68021,53358,909516,42.374232,-71.0378,750000,3-FAM RES,ROW-END
319104,76954,242150,1210748,42.333472,-71.031357,975000,2-FAM RES,ROW-MIDDLE
773434,56926,716508,1433015,42.333247,-71.027226,950000,MXU RES+COM,RAISED CAPE
124097,29927,94170,470848,42.2613,-71.124713,400000,1-FAM RES,RANCH
948216,152735,795481,2717892,42.341285,-71.079854,2050000,4-8 UNIT APT,CONDO/APT
535885,83807,452078,1506926,42.373788,-71.038946,1265000,MXU RES+COM,RAISED CAPE
302736,58268,244468,977871,42.33059,-71.042821,700000,4-8 UNIT APT,CONDO/APT
333947,80534,253413,1267063,42.293414,-71.137397,1127000,2-FAM RES,CONVENTIONAL
169421,40857,128564,642818,42.352201,-71.078174,500000,CONDOMINIUM,ROW-MIDDLE
2089640,288475,1801165,5432084,42.344114,-71.075168,4560000,CONDOMINIUM,ROW-MIDDLE
694523,289377,405146,4047408,42.343121,-71.075338,3600000,CONDOMINIUM,ROW-MIDDLE
0,0,0,1,42.32629,-71.096498,1,RES UDV LAND,CONVENTIONAL
303856,47520,256336,854452,42.358804,-71.072238,760000,CONDOMINIUM,MID-RISE
235495,56791,178704,893518,42.358897,-71.07179,695000,CONDOMINIUM,MID-RISE
624072,120117,503955,2015819,42.37809,-71.03418,1712500,4-8 UNIT APT,CONDO/APT
637077,153636,483441,2417202,42.340629,-71.147398,2150000,3-FAM RES,ROW-END
784912,189288,595624,2978116,42.34131,-71.079885,2500000,3-FAM RES,ROW-MIDDLE
29649,7150,22499,112493,42.288706,-71.057287,87500,1-FAM RES,COLONIAL
439113,68673,370440,1234800,42.340716,-71.052707,1049000,CONDOMINIUM,FREE-STANDNG
329663,79501,250162,1250808,42.324568,-71.0594,1050000,3-FAM RES,DECKER
3722902,897811,2825091,14125453,42.352187,-71.078231,12000000,EDUCATIONAL,CONDO/APT
1954524,471351,1483173,7415863,42.342136,-71.077352,6300000,1-FAM RES,ROW-MIDDLE
406204,97959,308245,1541224,42.371962,-71.035487,1200000,2-FAM RES,ROW-MIDDLE
406204,97959,308245,1541224,42.372002,-71.035441,1200000,3-FAM RES,ROW-MIDDLE
360015,86820,273195,1365972,42.324666,-71.059604,1100000,3-FAM RES,DECKER
2575007,620986,1954021,9770105,42.360399,-71.070732,8300000,MXU COM+RES,CONDO/APT
184766,93479,91287,1267871,42.369403,-71.033266,1000000,3-FAM RES,SEMI DETACHD
148506,35813,112693,563465,42.334558,-71.04782,425000,MXU RES+COM,RAISED CAPE
633381,152745,480636,2403177,42.362885,-71.05244,1700000,4-8 UNIT APT,CONDO/APT
186945,45083,141862,709308,42.373914,-71.038949,524000,MXU COM+RES,CONDO/APT
2298468,295532,2002936,5722672,42.354699,-71.075623,3900000,CONDOMINIUM,ROW-MIDDLE
203102,48979,154123,770612,42.280035,-71.152216,600000,1-FAM RES,COLONIAL
167155,45733,121422,697053,42.38195,-71.03185,620000,2-FAM RES,CONVENTIONAL
295965,46286,249679,832261,42.333374,-71.031111,648000,CONDOMINIUM,DECKER
156982,37857,119125,595623,42.2477,-71.117058,500000,2-FAM RES,CONVENTIONAL
512706,186176,326530,2669856,42.310774,-71.059348,2150000,4-8 UNIT APT,CONDO/APT
512706,186176,326530,2669856,42.310601,-71.05942,2150000,3-FAM RES,ROW-END
0,0,0,1,42.331932,-71.098381,1,MXU RES+COM,CONDO/APT
1013341,244376,768965,3844823,42.331999,-71.098649,2900000,WAREHOUSE,CONDO/APT
84626,20408,64218,321088,42.348192,-71.140894,250000,CONDOMINIUM,MID-RISE
232241,56007,176234,881170,42.330615,-71.041094,695000,2-FAM RES,CONVENTIONAL
316818,76403,240415,1202071,42.354738,-71.074773,935000,CONDOMINIUM,ROW-END
830387,200255,630132,3150660,42.365145,-71.057263,2485000,4-8 UNIT APT,CONDO/APT
109500,34933,74567,514255,42.332564,-71.035425,400000,3-FAM RES,DECKER
334160,80585,253575,1267871,42.334447,-71.053275,1000000,3-FAM RES,DECKER
1723431,97215,1626216,2849819,42.342448,-71.077507,2350000,1-FAM RES,ROW-MIDDLE
364744,87961,276783,1383913,42.353734,-71.053491,889000,CONDOMINIUM,HIGH-RISE
337889,65034,272855,1091420,42.358859,-71.146766,900000,1-FAM RES,COLONIAL
567796,30219,537577,917938,42.372882,-71.06191,724000,CONDOMINIUM,ROW-MIDDLE
180751,43589,137162,685810,42.28576,-71.139822,610000,1-FAM RES,COLONIAL
1670851,33721,1637130,2061571,42.364255,-71.056244,1700000,4-8 UNIT APT,CONDO/APT
397571,42335,355236,888090,42.342885,-71.08256,679900,CONDOMINIUM,ROW-MIDDLE
538269,129808,408461,2042305,42.343587,-71.069051,1735000,4-8 UNIT APT,CONDO/APT
286531,69099,217432,1087157,42.305331,-71.113933,820000,3-FAM RES,DECKER
60650,14626,46024,230119,42.298942,-71.082072,170000,3-FAM RES,CONVENTIONAL
376168,90716,285452,1427259,42.276401,-71.139391,1212500,3-FAM RES,DECKER
546617,58206,488411,1221027,42.370295,-71.038164,1025000,3-FAM RES,ROW-MIDDLE
629669,151850,477819,2389095,42.320031,-71.093186,2125000,4-8 UNIT APT,CONDO/APT
1967381,1290560,676821,16920538,42.35358,-71.072956,12500000,OTHER EXEMPT,ROW-MIDDLE
470063,73513,396550,1321831,42.366072,-71.036409,1090000,3-FAM RES,DECKER
277851,67006,210845,1054223,42.254049,-71.12476,820000,FRAT ORGANIZ,CONDO/APT
503736,121480,382256,1911276,42.3792,-71.068074,1700000,2-FAM RES,ROW-END
217872,52541,165331,826652,42.302202,-71.134163,652000,1-FAM RES,CAPE COD
76378,18419,57959,289794,42.305092,-71.073025,205000,3-FAM RES,DECKER
479215,92236,386979,1547914,42.320015,-71.059132,1315000,3-FAM RES,DECKER
283272,68313,214959,1074793,42.34585,-71.070777,836000,CONDOMINIUM,ROW-END
94346,22752,71594,357966,42.276021,-71.076561,270000,1-FAM RES,COLONIAL
172132,41511,130621,653104,42.369947,-71.040785,500000,3-FAM RES,SEMI DETACHD
373904,82859,291045,1333957,42.306911,-71.059892,1100000,3-FAM RES,DECKER
48793,38508,10285,494970,42.269449,-71.097826,385000,3-FAM RES,DECKER
136179,32840,103339,516693,42.337413,-71.040099,321000,CONDOMINIUM,ROW-MIDDLE
763783,184193,579590,2897949,42.358981,-71.064942,2050000,9 + UNIT APT,CONDO/APT
162684,39232,123452,617258,42.345864,-71.105797,509000,CONDOMINIUM,ROW-MIDDLE
25061,6043,19018,95090,42.317744,-71.08104,75000,RES UDV LAND,CONDO/APT
156982,37857,119125,595623,42.309941,-71.106239,500000,2-FAM RES,TWO FAMILY
292837,56363,236474,945897,42.375062,-71.033516,780000,3-FAM RES,DECKER
70868,17090,53778,268887,42.344564,-71.094764,159000,CONDOMINIUM,MID-RISE
74478,17961,56517,282585,42.351019,-71.132674,199900,CONDOMINIUM,LOW-RISE
115091,27755,87336,436680,42.247687,-71.111359,340000,1-FAM RES,THREE STORY
666170,32234,633936,1039654,42.356737,-71.070034,820000,CONDOMINIUM,MID-RISE
319616,77078,242538,1212689,42.356737,-71.070034,1000000,CONDOMINIUM,MID-RISE
1666318,36005,1630313,2083504,42.331604,-71.104894,1770000,3-FAM RES,DECKER
52135,34779,17356,455115,42.354891,-71.150361,354000,1-FAM RES,COLONIAL
187696,45264,142432,712158,42.275054,-71.146715,605000,1-FAM RES,COLONIAL
257520,62103,195417,977084,42.351592,-71.049453,760000,CONDOMINIUM,MID-RISE
361477,87173,274304,1371518,42.366245,-71.056365,1050000,4-8 UNIT APT,CONDO/APT
569255,137281,431974,2159871,42.344065,-71.068497,1680000,1-FAM RES,ROW-END
191769,46246,145523,727613,42.28577,-71.168039,600000,2-FAM RES,CONVENTIONAL
114512,22040,92472,369888,42.276855,-71.164263,329000,CONDOMINIUM,LOW-RISE
214828,51807,163021,815102,42.292254,-71.152721,725000,2-FAM RES,TWO FAMILY
57603,13891,43712,218558,42.27658,-71.164131,170000,CONDOMINIUM,LOW-RISE
1635486,394412,1241074,6205370,42.348809,-71.081814,4228959,CONDOMINIUM,HIGH-RISE
170633,41149,129484,647416,42.336487,-71.084002,550000,1-FAM RES,ROW-END
347470,83795,263675,1318375,42.324924,-71.057258,1120000,3-FAM RES,CONVENTIONAL
565136,136287,428849,2144243,42.322226,-71.113024,1800000,2-FAM RES,CONVENTIONAL
297831,71824,226007,1130032,42.361894,-71.142958,910000,2-FAM RES,CONVENTIONAL
225105,54286,170819,854095,42.333532,-71.030945,665000,1-FAM RES,DUPLEX
153308,43586,109721,548607,42.276094,-71.124385,420000,1-FAM RES,BNGL/COTTAGE
153308,43586,109721,548607,42.275944,-71.124259,420000,1-FAM RES,BNGL/COTTAGE
0,0,0,1,42.316923,-71.074028,1,2-FAM RES,SEMI DETACHD
37408,9021,28387,141931,42.319178,-71.054301,100000,CONDOMINIUM,LOW-RISE
29454,7103,22351,111756,42.319178,-71.054301,80000,CONDOMINIUM,LOW-RISE
1195456,13989,1181467,1357549,42.319211,-71.054294,925170,CONDOMINIUM,LOW-RISE
38673,9326,29347,146735,42.319211,-71.054294,100000,CONDOMINIUM,LOW-RISE
38673,9326,29347,146735,42.319257,-71.054289,100000,CONDOMINIUM,LOW-RISE
35676,8603,27073,135364,42.319291,-71.054288,100000,CONDOMINIUM,LOW-RISE
114789,27682,87107,435534,42.34463,-71.094625,370000,CONDOMINIUM,MID-RISE
0,0,0,1,42.360798,-71.067017,1,CONDOMINIUM,ROW-MIDDLE
0,0,0,1,42.360798,-71.067017,1,CONDOMINIUM,ROW-MIDDLE
0,0,0,1,42.360798,-71.067017,1,CONDOMINIUM,ROW-MIDDLE
0,0,0,1,42.360798,-71.067017,1,CONDOMINIUM,ROW-MIDDLE
2301186,182368,2118818,4414204,42.362594,-71.052226,3750000,4-8 UNIT APT,CONDO/APT
521206,125693,395513,1977563,42.341978,-71.057129,1680000,CONDOMINIUM,MID-RISE
277353,66886,210467,1052333,42.342116,-71.057013,830000,CONDOMINIUM,MID-RISE
115661,27892,87769,438841,42.340345,-71.053233,361875,CONDOMINIUM,FREE-STANDNG
4655,1122,3533,17662,42.346011,-71.07408,10000,CONDOMINIUM,ROW-END
131892,31806,100086,500426,42.342116,-71.057013,354000,CONDOMINIUM,MID-RISE
1549509,373678,1175831,5879154,42.354676,-71.075708,4158895,CONDOMINIUM,MID-RISE
130301,31423,98878,494390,42.247586,-71.127566,420000,2-FAM RES,CONVENTIONAL
3012672,579859,2432813,9731250,42.347569,-71.141078,7450000,GEN OFFICE,CONDO/APT
199058,38313,160745,642980,42.356912,-71.060201,475000,CONDOMINIUM,HIGH-RISE
1661463,348066,1313397,5694352,42.332326,-71.099844,3775000,MXU RES+COM,RAISED CAPE
0,0,0,1,42.332228,-71.099483,1,MXU RES+COM,CONDO/APT
0,0,0,1,42.332326,-71.099844,1,MXU RES+COM,RAISED CAPE
763801,184197,579604,2898019,42.354716,-71.074855,1975000,CONDOMINIUM,ROW-MIDDLE
484762,137821,346940,1734703,42.365212,-71.057271,1150000,MXU COM+RES,CONDO/APT
516905,99490,417415,1669659,42.31038,-71.088019,1300000,9 + UNIT APT,CONDO/APT
247784,59755,188029,940146,42.374041,-71.038951,732000,MXU RES+COM,RAISED CAPE
327287,78928,248359,1241793,42.332998,-71.029283,1000000,3-FAM RES,ROW-END
108625,57200,51425,771382,42.377021,-71.034984,600000,3-FAM RES,ROW-MIDDLE
297056,71637,225419,1127093,42.350359,-71.048463,957500,CONDOMINIUM,MID-RISE
199717,48163,151554,757768,42.355397,-71.063003,590000,CONDOMINIUM,HIGH-RISE
65331,15755,49576,247880,42.342496,-71.14601,193000,CONDOMINIUM,LOW-RISE
1123973,202330,921643,3468290,42.365765,-71.055258,2860000,9 + UNIT APT,CONDO/APT
199701,94278,105423,1292066,42.332377,-71.099679,1005000,OTHER EXEMPT,RAISED CAPE
751567,76607,674960,1639188,42.334181,-71.102852,1275000,3-FAM RES,ROW-MIDDLE
492166,15431,476735,670959,42.253563,-71.131601,570000,3-FAM RES,DECKER
203102,48979,154123,770612,42.379961,-71.033305,600000,3-FAM RES,DECKER
1435956,184632,1251324,3575210,42.342558,-71.077616,3180000,1-FAM RES,ROW-MIDDLE
50422,12159,38263,191311,42.287514,-71.0829,148807,1-FAM RES,COLONIAL
298062,71880,226182,1130907,42.345232,-71.141456,800000,4-8 UNIT APT,CONDO/APT
186975,45090,141885,709423,42.35256,-71.158849,585000,1-FAM RES,CONVENTIONAL
51366,12387,38979,194892,42.383244,-71.014548,147000,1-FAM RES,CAPE COD
316864,53571,263293,937578,42.369526,-71.040995,730000,3-FAM RES,ROW-MIDDLE
80426,19395,61031,305151,42.311832,-71.088325,215000,3-FAM RES,CONVENTIONAL
1185949,286002,899947,4499732,42.365576,-71.055109,3500000,9 + UNIT APT,CONDO/APT
214045,71436,142609,1041752,42.334352,-71.048019,885000,1-FAM RES,COLONIAL
203102,48979,154123,770612,42.379992,-71.033222,600000,3-FAM RES,DECKER
1078091,259991,818100,4090496,42.342149,-71.075366,3475000,1-FAM RES,ROW-MIDDLE
1035219,93522,941697,2118818,42.330166,-71.038799,1800000,2-FAM RES,CONVENTIONAL
528922,127554,401368,2006839,42.331334,-71.106767,1785000,4-8 UNIT APT,CONDO/APT
27819,6708,21111,105552,42.334472,-71.035276,85000,CONDOMINIUM,LOW-RISE
629691,151855,477836,2389180,42.343387,-71.076796,1765000,2-FAM RES,ROW-MIDDLE
295347,61840,233507,1011860,42.333014,-71.101744,650000,MXU RES+COM,RAISED CAPE
308256,111956,196300,1605441,42.333067,-71.101888,1250000,3-FAM RES,DECKER
42541,10259,32282,161408,42.274679,-71.166793,110000,1-FAM RES,COLONIAL
206558,49813,156745,783724,42.320681,-71.06265,600000,3-FAM RES,DECKER
238114,57423,180691,903453,42.281803,-71.072203,745000,2-FAM RES,TWO FAMILY
66592,16059,50533,252663,42.337028,-71.050856,167500,1-FAM RES,SEMI DETACHD
173294,27101,146193,487311,42.333,-71.03134,360000,CONDOMINIUM,ROW-END
339290,65304,273986,1095946,42.378217,-71.033833,920000,3-FAM RES,SEMI DETACHD
82712,19946,62766,313826,42.271724,-71.077753,222000,3-FAM RES,DECKER
327607,79005,248602,1243006,42.334087,-71.053781,1025000,1-FAM RES,SEMI DETACHD
327607,79005,248602,1243006,42.334025,-71.053704,1025000,1-FAM RES,SEMI DETACHD
77061,18583,58478,292386,42.344044,-71.142261,216000,CONDOMINIUM,ROW-MIDDLE
707439,138470,568969,2311836,42.330274,-71.100538,1800000,3-FAM RES,DECKER
596301,148062,448239,2311836,42.331051,-71.0976,1800000,3-FAM RES,DECKER
543293,104569,438724,1754895,42.333201,-71.101978,1365000,MXU RES+COM,RAISED CAPE
294238,56633,237605,950421,42.352561,-71.15897,740000,2-FAM RES,CONVENTIONAL
138926,33503,105423,527111,42.379086,-71.034121,410000,2-FAM RES,CONVENTIONAL
835724,201542,634182,3170908,42.365935,-71.055151,2342500,MXU COM+RES,CONDO/APT
1472791,355176,1117615,5588071,42.357419,-71.071997,4500000,1-FAM RES,ROW-MIDDLE
591704,142694,449010,2245048,42.365935,-71.055151,1530000,MXU COM+RES,CONDO/APT
725128,174871,550257,2751284,42.365935,-71.055151,1875000,MXU COM+RES,CONDO/APT
620484,149635,470849,2354242,42.324207,-71.059803,2000000,3-FAM RES,DECKER
135481,17769,117712,341365,42.369661,-71.032959,290000,CONDOMINIUM,ROW-END
14727,3551,11176,55878,42.343562,-71.082432,40000,CONDOMINIUM,ROW-END
584750,62266,522484,1306208,42.329884,-71.037607,1000000,3-FAM RES,DECKER
177789,42875,134914,674568,42.357598,-71.052925,600000,CONDOMINIUM,HIGH-RISE
497935,120081,377854,1889266,42.353653,-71.053436,1425000,CONDOMINIUM,HIGH-RISE
246154,45153,201001,769327,42.357255,-71.149165,599000,CONDOMINIUM,FREE-STANDNG
251172,60572,190600,952997,42.333633,-71.037242,800000,2-FAM RES,ROW-END
66319,15993,50326,251626,42.314571,-71.066836,178000,3-FAM RES,DECKER
628359,178647,449712,2248560,42.343496,-71.069348,2000000,1-FAM RES,ROW-END
198765,144284,54481,1870528,42.332126,-71.099273,1339000,4-8 UNIT APT,CONDO/APT
189603,45724,143879,719391,42.329303,-71.056194,550748,2-FAM RES,DECKER
155496,37499,117997,589981,42.329303,-71.056194,445000,2-FAM RES,DECKER
911302,62266,849036,1632760,42.300193,-71.085621,1250000,4-8 UNIT APT,CONDO/APT
173032,41728,131304,656516,42.340903,-71.078611,485000,CONDOMINIUM,ROW-MIDDLE
248194,59854,188340,941696,42.380315,-71.064165,800000,2-FAM RES,ROW-END
336666,81190,255476,1277379,42.33659,-71.075792,900000,2-FAM RES,CONDO/APT
474773,24679,450094,760722,42.288526,-71.076468,600000,3-FAM RES,DECKER
1216140,293283,922857,4614281,42.345022,-71.079966,3805000,3-FAM RES,ROW-MIDDLE
698981,109314,589667,1965556,42.310535,-71.051896,1650000,3-FAM RES,CONVENTIONAL
42619,9192,33427,149134,42.285197,-71.093776,116000,CONDOMINIUM,ROW-END
456407,110066,346341,1731701,42.366591,-71.05527,1225000,4-8 UNIT APT,CONDO/APT
470947,113573,357374,1786869,42.346263,-71.072037,1500000,1-FAM RES,ROW-MIDDLE
154693,37305,117388,586940,42.33083,-71.055857,400000,3-FAM RES,DECKER
123787,29852,93935,469671,42.247985,-71.127201,399000,2-FAM RES,CONVENTIONAL
1435257,346125,1089132,5445659,42.366532,-71.054771,4240000,4-8 UNIT APT,CONDO/APT
253126,61043,192083,960412,42.311575,-71.07783,757500,3-FAM RES,CONVENTIONAL
38673,9326,29347,146735,42.294211,-71.056616,100000,CONDOMINIUM,FREE-STANDNG
910322,98136,812186,2047385,42.35878,-71.065724,1512500,4-8 UNIT APT,ROW-MIDDLE
440156,106147,334009,1670043,42.329512,-71.056293,1299000,2-FAM RES,CONDO/APT
56513,13628,42885,214424,42.270063,-71.100857,180000,1-FAM RES,CAPE COD
2337982,305522,2032460,5877936,42.356611,-71.070226,4500000,9 + UNIT APT,CONDO/APT
873570,210669,662901,3314503,42.356611,-71.070226,2500000,9 + UNIT APT,CONDO/APT
524784,126556,398228,1991137,42.36079,-71.065853,1320000,4-8 UNIT APT,CONDO/APT
316232,76262,239970,1199850,42.330984,-71.098196,905000,3-FAM RES,SEMI DETACHD
851361,163864,687497,2749988,42.330984,-71.098196,2446000,3-FAM RES,SEMI DETACHD
173735,41897,131838,659187,42.283809,-71.12343,560000,1-FAM RES,COLONIAL
342016,82480,259536,1297680,42.341291,-71.151327,785000,4-8 UNIT APT,SEMI DETACHD
257520,62103,195417,977084,42.325221,-71.057242,760000,3-FAM RES,DECKER
116244,28033,88211,441053,42.326848,-71.10115,312000,3-FAM RES,DECKER
257519,62103,195416,977080,42.283697,-71.087088,760757,CONDOMINIUM,DECKER
257519,62103,195416,977080,42.283697,-71.087088,760757,CONDOMINIUM,DECKER
257519,62103,195416,977080,42.283697,-71.087088,760757,CONDOMINIUM,DECKER
257519,62103,195416,977080,42.283697,-71.087088,760757,CONDOMINIUM,DECKER
257519,62103,195416,977080,42.283697,-71.087088,760757,CONDOMINIUM,DECKER
257519,62103,195416,977080,42.283697,-71.087088,760757,CONDOMINIUM,DECKER
55227,13318,41909,209543,42.304121,-71.067733,150000,3-FAM RES,CONVENTIONAL
73224,17658,55566,277827,42.29542,-71.115735,229100,CONDOMINIUM,FREE-STANDNG
50441,12164,38277,191383,42.286611,-71.091208,137000,2-FAM RES,CONVENTIONAL
44181,10654,33527,167635,42.27148,-71.092408,120000,3-FAM RES,CONVENTIONAL
232681,56113,176568,882840,42.330304,-71.094561,750000,2-FAM RES,TWO FAMILY
2240608,408574,1832034,6974585,42.34201,-71.0703,5425000,MXU RES+COM,CONDO/APT
639232,154156,485076,2425378,42.339929,-71.049508,2000000,4-8 UNIT APT,CONDO/APT
220918,53276,167642,838210,42.351537,-71.078204,675000,CONDOMINIUM,MID-RISE
232706,108526,124180,1490152,42.334092,-71.048343,1200000,3-FAM RES,SEMI DETACHD
146876,100417,46459,1310371,42.33246,-71.041335,1100000,2-FAM RES,ROW-MIDDLE
204314,49272,155042,775208,42.337287,-71.037355,458400,2-FAM RES,CONVENTIONAL
335143,84694,250449,1316462,42.334976,-71.051716,1025000,1-FAM RES,CONDO/APT
358541,86465,272076,1360378,42.36589,-71.035128,1210000,3-FAM RES,SEMI DETACHD
315875,76176,239699,1198494,42.333201,-71.101978,725000,MXU RES+COM,RAISED CAPE
225558,54395,171163,855813,42.377147,-71.032553,675000,3-FAM RES,ROW-MIDDLE
722119,174145,547974,2739867,42.369709,-71.032903,2300000,4-8 UNIT APT,CONDO/APT
684356,165038,519318,2596590,42.343679,-71.076798,2091000,1-FAM RES,ROW-MIDDLE
1606000,309112,1296888,5187549,42.3436,-71.075783,4035000,1-FAM RES,ROW-MIDDLE
130915,31571,99344,496717,42.304085,-71.070203,400000,1-FAM RES,COLONIAL
160789,38775,122014,610067,42.324168,-71.093151,475000,RES DEV LAND,CONTEMPORARY
13583,3275,10308,51539,42.314568,-71.088224,42500,1-FAM RES,CONVENTIONAL
376495,66370,310125,1145506,42.348007,-71.138843,820000,3-FAM RES,DECKER
627929,151430,476499,2382493,42.332736,-71.029029,2000000,3-FAM RES,ROW-MIDDLE
335046,80799,254247,1271233,42.367038,-71.057973,910000,4-8 UNIT APT,CONDO/APT
390663,38716,351947,839258,42.369756,-71.032847,620000,4-8 UNIT APT,CONDO/APT
834840,201329,633511,3167554,42.352775,-71.079293,2425000,CONDOMINIUM,MID-RISE
242266,58424,183842,919206,42.352775,-71.079293,725000,CONDOMINIUM,MID-RISE
398358,96067,302291,1511454,42.352775,-71.079293,1268801,CONDOMINIUM,MID-RISE
175575,42341,133234,666166,42.379005,-71.033798,510000,2-FAM RES,CONVENTIONAL
1748419,421647,1326772,6633859,42.351987,-71.078989,4674000,9 + UNIT APT,ROW-MIDDLE
735003,134671,600332,2295386,42.304489,-71.114578,1950000,4-8 UNIT APT,CONDO/APT
100596,24259,76337,381681,42.380084,-71.032975,270000,4-8 UNIT APT,CONDO/APT
98975,23868,75107,375534,42.294684,-71.061662,287500,1-FAM RES,SEMI DETACHD
127184,30671,96513,482565,42.294895,-71.061847,340000,3-FAM RES,DECKER
588575,141780,446795,2231323,42.365654,-71.057572,1683000,4-8 UNIT APT,CONDO/APT
0,0,0,1,42.31906,-71.07763,1,MXU RES+COM,RAISED CAPE
414841,100042,314799,1573992,42.294273,-71.061785,1400000,MXU COM+RES,RAISED CAPE
628482,151564,476918,2384590,42.342889,-71.077945,1442500,2-FAM RES,ROW-MIDDLE
465363,112226,353137,1765681,42.366476,-71.032367,1500000,1-FAM RES,COLONIAL
215165,51889,163276,816380,42.33247,-71.02926,635000,3-FAM RES,ROW-MIDDLE
894896,201538,693358,3230033,42.352637,-71.083224,1910000,CONDOMINIUM,HIGH-RISE
695165,167645,527520,2637598,42.354233,-71.063727,2175000,CONDOMINIUM,HIGH-RISE
702000,169293,532707,2663534,42.354233,-71.063727,2009000,CONDOMINIUM,HIGH-RISE
1239485,352395,887090,4435450,42.354321,-71.063812,3450000,CONDOMINIUM,HIGH-RISE
1470234,354560,1115674,5578369,42.343549,-71.07563,4600000,2-FAM RES,ROW-END
271504,65475,206029,1030145,42.315685,-71.102769,812500,2-FAM RES,CONVENTIONAL
271504,65475,206029,1030145,42.315584,-71.102691,812500,3-FAM RES,CONVENTIONAL
102658,59196,43462,788538,42.34048,-71.076636,635000,CONDOMINIUM,ROW-MIDDLE
258198,62266,195932,979656,42.3372,-71.050939,750000,1-FAM RES,COLONIAL
516511,101165,415346,1688669,42.369315,-71.032763,1392500,4-8 UNIT APT,CONDO/APT
222739,53715,169024,845116,42.388897,-71.005408,647000,3-FAM RES,DECKER
167167,32175,134992,539967,42.366425,-71.032244,420000,1-FAM RES,ROW-END
992774,239416,753358,3766787,42.366412,-71.05471,3200000,MXU RES+COM,CONDO/APT
90851,21909,68942,344708,42.342147,-71.14538,260000,CONDOMINIUM,MID-RISE
3519972,73995,3445977,4377322,42.35261,-71.079555,3525000,CONDOMINIUM,ROW-END
431481,104055,327426,1637130,42.380063,-71.06757,1350000,3-FAM RES,DECKER
1278750,98256,1180494,2417202,42.33723,-71.037596,2150000,3-FAM RES,ROW-END
39121,9434,29687,148431,42.294268,-71.052703,105000,CONDOMINIUM,FREE-STANDNG
249176,137007,112169,1836625,42.356682,-71.071896,1430000,CONDOMINIUM,ROW-END
646392,155883,490509,2452542,42.342944,-71.078,1975000,2-FAM RES,ROW-END
230114,55494,174620,873099,42.331709,-71.107459,625000,2-FAM RES,CONVENTIONAL
92450,22295,70155,350775,42.342039,-71.145744,312000,CONDOMINIUM,LOW-RISE
68209,16449,51760,258797,42.342039,-71.145744,201500,CONDOMINIUM,LOW-RISE
68107,16424,51683,258413,42.342039,-71.145744,201000,CONDOMINIUM,LOW-RISE
2547242,614290,1932952,9664760,42.35455,-71.075815,7525000,CONDOMINIUM,ROW-MIDDLE
446535,95117,351418,1548620,42.369283,-71.032715,1300000,4-8 UNIT APT,CONDO/APT
229100,55249,173851,869255,42.332052,-71.041322,700000,FRAT ORGANIZ,RAISED CAPE
437932,184854,253078,2579761,42.35258,-71.079309,1975000,CONDOMINIUM,ROW-MIDDLE
165979,40027,125952,629759,42.286407,-71.123045,535000,1-FAM RES,COLONIAL
691359,93177,598182,1770962,42.353745,-71.129173,1396800,3-FAM RES,DECKER
308727,0,308727,308728,42.304146,-71.06969,221000,3-FAM RES,DECKER
1981290,385391,1595899,6446655,42.345379,-71.087848,5316000,9 + UNIT APT,CONDO/APT
1497414,51071,1446343,2089161,42.339929,-71.049508,1625000,4-8 UNIT APT,CONDO/APT
207750,50100,157650,788247,42.333915,-71.053239,650000,1-FAM RES,COLONIAL
729068,175821,553247,2766234,42.329651,-71.034422,2350000,2-FAM RES,CONVENTIONAL
105260,25384,79876,399379,42.341899,-71.146482,315000,CONDOMINIUM,MID-RISE
110597,26671,83926,419629,42.363418,-71.066692,310000,CONDOMINIUM,HIGH-RISE
1525946,112312,1413634,2827267,42.353653,-71.053436,2000000,CONDOMINIUM,HIGH-RISE
279544,67414,212130,1060651,42.331052,-71.033674,825000,1-FAM RES,CONDO/APT
1201143,289666,911477,4557382,42.343578,-71.069063,3670000,1-FAM RES,ROW-END
174713,42133,132580,662900,42.28474,-71.054687,500000,3-FAM RES,DECKER
363901,87758,276143,1380715,42.34236,-71.08194,1020000,CONDOMINIUM,ROW-MIDDLE
231429,55811,175618,878090,42.377275,-71.063781,683000,CONDOMINIUM,ROW-END
214330,53625,160705,835664,42.369703,-71.035137,650000,3-FAM RES,DECKER
736365,177581,558784,2793919,42.346055,-71.080015,2000000,9 + UNIT APT,CONDO/APT
405000,97669,307331,1536655,42.350788,-71.084816,1100000,CONDOMINIUM,ROW-END
103279,24906,78373,391862,42.278133,-71.128432,300000,1-FAM RES,BNGL/COTTAGE
249456,207547,41909,2654223,42.335683,-71.083942,1900000,4-8 UNIT APT,CONDO/APT
103244,24898,78346,391727,42.304281,-71.058733,305000,3-FAM RES,DECKER
4385463,1057594,3327869,16639344,42.358424,-71.068599,14800000,1-FAM RES,ROW-MIDDLE
89046,21474,67572,337858,42.266848,-71.096521,239000,3-FAM RES,DECKER
326996,78858,248138,1240690,42.343576,-71.150735,822500,2-FAM RES,TWO FAMILY
105853,25527,80326,401630,42.328847,-71.091886,258000,1-FAM RES,ROW-MIDDLE
217204,52380,164824,824116,42.375104,-71.033468,650000,3-FAM RES,DECKER
899702,216971,682731,3413651,42.331185,-71.053557,2900000,3-FAM RES,DECKER
70848,16914,53934,266830,42.253938,-71.123185,188000,3-FAM RES,CONVENTIONAL
237442,41511,195931,718414,42.317597,-71.059232,550000,3-FAM RES,DECKER
125656,30303,95353,476765,42.34327,-71.104387,365000,CONDOMINIUM,MID-RISE
38529,9291,29238,146189,42.317026,-71.081621,103000,3-FAM RES,CONVENTIONAL
59851,14433,45418,227089,42.340014,-71.158807,160000,CONDOMINIUM,MID-RISE
88894,21437,67457,337284,42.305643,-71.081666,300000,2-FAM RES,TWO FAMILY
811573,126922,684651,2282168,42.326869,-71.100761,1800000,3-FAM RES,DECKER
199917,48211,151706,758526,42.38046,-71.038623,590000,2-FAM RES,CONVENTIONAL
251683,60695,190988,954939,42.329325,-71.091736,769000,3-FAM RES,DECKER
215282,57512,157770,881657,42.328288,-71.089811,665000,3-FAM RES,CONDO/APT
355784,85800,269984,1349919,42.330144,-71.05372,1050000,RES-MTL BLDG,CONDO/APT
95561,23045,72516,362580,42.346603,-71.168381,322500,CONDOMINIUM,LOW-RISE
435889,105118,330771,1653855,42.374086,-71.034073,1405000,3-FAM RES,SEMI DETACHD
101551,24489,77062,385306,42.286718,-71.079086,300000,2-FAM RES,CONVENTIONAL
98935,25193,73742,390836,42.354494,-71.075674,214000,CONDOMINIUM,MID-RISE
268798,64823,203975,1019875,42.357512,-71.1379,841003,1-FAM RES,COLONIAL
271673,65516,206157,1030785,42.337127,-71.037593,850000,1-FAM RES,ROW-END
202933,48939,153994,769969,42.332102,-71.033375,599500,CONDOMINIUM,DECKER
115609,27880,87729,438645,42.354533,-71.075879,314000,CONDOMINIUM,MID-RISE
93339,22509,70830,354148,42.303636,-71.114703,315000,CONDOMINIUM,LOW-RISE
114789,27682,87107,435534,42.303636,-71.114703,370000,CONDOMINIUM,LOW-RISE
136341,42326,94015,626764,42.380207,-71.032645,488000,3-FAM RES,CONVENTIONAL
294729,71076,223653,1118265,42.279602,-71.132169,950000,3-FAM RES,CONVENTIONAL
482471,15459,467012,661600,42.24464,-71.136757,425000,2-FAM RES,DUPLEX
296315,71459,224856,1124280,42.358726,-71.12421,1000000,1-FAM RES,COLONIAL
348170,83964,264206,1321029,42.358785,-71.124333,1175000,2-FAM RES,CONVENTIONAL
804900,19541,785359,1031318,42.28277,-71.134727,662500,2-FAM RES,TWO FAMILY
219282,52881,166401,832001,42.365907,-71.057508,670000,PARKING LOT,CONDO/APT
151022,36340,114682,572083,42.314262,-71.075344,431500,3-FAM RES,DECKER
209521,40327,169194,676777,42.312991,-71.072715,545000,2-FAM RES,CONVENTIONAL
403314,97262,306052,1530257,42.312991,-71.072715,1300000,2-FAM RES,CONVENTIONAL
651508,157117,494391,2471954,42.369384,-71.037444,2100000,MXU RES+COM,RAISED CAPE
651508,157117,494391,2471954,42.369326,-71.037313,2100000,MXU RES+COM,RAISED CAPE
651508,157117,494391,2471954,42.369268,-71.037182,2100000,MXU RES+COM,RAISED CAPE
114544,27623,86921,434601,42.346442,-71.140661,270000,CONDOMINIUM,LOW-RISE
526845,101403,425442,1701768,42.333786,-71.049005,1325000,MXU COM+RES,RAISED CAPE
77954,18799,59155,295774,42.30942,-71.049477,190000,CONDOMINIUM,FREE-STANDNG
209463,50513,158950,794747,42.378648,-71.033202,640000,2-FAM RES,ROW-END
800086,125126,674960,2249866,42.33199,-71.101753,1750000,3-FAM RES,DECKER
290417,70036,220381,1101903,42.33472,-71.051324,925000,3-FAM RES,SEMI DETACHD
2017390,153215,1864175,3792631,42.343169,-71.07666,2950000,4-8 UNIT APT,CONDO/APT
260292,62771,197521,987604,42.341581,-71.149933,839000,MXU RES+COM,RAISED CAPE
61259,24357,36902,343473,42.290641,-71.063052,242000,3-FAM RES,DECKER
2105208,507690,1597518,7987588,42.354449,-71.075838,6300000,9 + UNIT APT,ROW-MIDDLE
906585,218631,687954,3439768,42.35179,-71.079728,2770000,CONDOMINIUM,ROW-MIDDLE
695733,74587,621146,1559941,42.337535,-71.046757,1256200,1-FAM RES,CONVENTIONAL
880239,391827,488412,5420172,42.352634,-71.07983,4550000,CONDOMINIUM,ROW-MIDDLE
69885,16853,53032,265160,42.273337,-71.101469,200000,2-FAM RES,CONVENTIONAL
282320,68084,214236,1071180,42.341604,-71.149582,910000,MXU RES+COM,RAISED CAPE
281500,67886,213614,1068066,42.341697,-71.149596,950000,3-FAM RES,ROW-MIDDLE
559085,134828,424257,2121282,42.35261,-71.079555,1600000,CONDOMINIUM,ROW-MIDDLE
4422978,481739,3941239,10004684,42.363168,-71.054152,8250000,MXU RES+COM,CONDO/APT
2280310,412860,1867450,7063944,42.363168,-71.054152,5500000,MXU RES+COM,CONDO/APT
76704,18497,58207,291033,42.341576,-71.149946,215000,CONDOMINIUM,ROW-END
209574,50540,159034,795169,42.341425,-71.150276,562500,2-FAM RES,ROW-MIDDLE
210964,50875,160089,800442,42.262264,-71.105738,680000,1-FAM RES,COLONIAL
174977,42197,132780,663896,42.310114,-71.076348,564000,3-FAM RES,ROW-MIDDLE
249201,60097,189104,945519,42.373905,-71.034121,841000,3-FAM RES,ROW-MIDDLE
275411,66417,208994,1044966,42.317074,-71.101537,800000,3-FAM RES,CONVENTIONAL
173387,42133,131254,661574,42.273167,-71.067802,499000,2-FAM RES,CONVENTIONAL
257728,62153,195575,977871,42.345112,-71.076756,700000,CONDOMINIUM,ROW-MIDDLE
178658,115071,63587,1511939,42.34401,-71.144762,856000,3-FAM RES,DECKER
1140813,275117,865696,4328478,42.359805,-71.063566,3850000,CONDOMINIUM,MID-RISE
1779224,278254,1500970,5003235,42.344094,-71.075887,4200000,1-FAM RES,ROW-MIDDLE
1005679,193177,812502,3243943,42.340694,-71.151195,2675000,3-FAM RES,CONVENTIONAL
724855,127127,597728,2197832,42.340694,-71.151195,1682605,3-FAM RES,CONVENTIONAL
222979,53773,169206,846026,42.354404,-71.076001,625000,CONDOMINIUM,ROW-MIDDLE
112919,27231,85688,428436,42.287937,-71.086748,328000,3-FAM RES,CONVENTIONAL
267052,75925,191127,955638,42.329434,-71.101773,850000,2-FAM RES,TWO FAMILY
111904,35504,76400,523275,42.316649,-71.107179,431500,1-FAM RES,COLONIAL
133329,32153,101176,505880,42.305189,-71.076782,399000,2-FAM RES,SEMI DETACHD
133329,32153,101176,505880,42.305189,-71.076782,399000,2-FAM RES,SEMI DETACHD
575629,158001,417628,2406329,42.352587,-71.080009,1815000,CONDOMINIUM,ROW-MIDDLE
1352621,211537,1141084,3803613,42.345888,-71.087193,3000000,CONDOMINIUM,ROW-MIDDLE
1828793,441030,1387763,6938813,42.287523,-71.152798,4600000,9 + UNIT APT,CONDO/APT
367277,88572,278705,1393523,42.380211,-71.063823,1085000,3-FAM RES,SEMI DETACHD
69686,63265,6421,802720,42.285372,-71.069907,625000,3-FAM RES,CONVENTIONAL
100596,24259,76337,381681,42.304842,-71.109857,270000,CONDOMINIUM,ROW-END
100596,24259,76337,381681,42.304914,-71.110043,270000,CONDOMINIUM,ROW-MIDDLE
194753,46966,147787,738933,42.262435,-71.15468,447000,1-FAM RES,COLONIAL
399273,88644,310629,1426355,42.348863,-71.161096,1125000,3-FAM RES,DECKER
351133,84678,266455,1332271,42.353237,-71.150037,1185000,2-FAM RES,CONVENTIONAL
1272601,306899,965702,4828509,42.352018,-71.080608,3201000,9 + UNIT APT,SEMI DETACHD
280951,90552,190399,1330146,42.289114,-71.090293,1130000,3-FAM RES,DECKER
218554,52706,165848,829236,42.285445,-71.05451,645000,2-FAM RES,TWO FAMILY
57646,13901,43745,218723,42.275034,-71.088454,145000,2-FAM RES,TWO FAMILY
311559,75135,236424,1182118,42.343299,-71.069858,905000,CONDOMINIUM,ROW-END
29814,24192,5622,310119,42.292853,-71.051338,218500,CONDOMINIUM,DECKER
85623,20648,64975,324874,42.369821,-71.040263,240000,4-8 UNIT APT,ROW-END
497849,64312,433537,1243006,42.296548,-71.059805,1025000,3-FAM RES,CONVENTIONAL
169421,40857,128564,642818,42.313513,-71.061133,500000,3-FAM RES,DECKER
103347,24923,78424,392119,42.278038,-71.076244,305000,1-FAM RES,COLONIAL
271073,65371,205702,1028510,42.329512,-71.056293,800000,1-FAM RES,CONDO/APT
147727,45861,101866,679105,42.236482,-71.13306,560000,1-FAM RES,CONVENTIONAL
198008,47751,150257,751285,42.265574,-71.099926,605000,3-FAM RES,DECKER
171918,41459,130459,652294,42.309853,-71.101719,492000,CONDOMINIUM,FREE-STANDNG
68139,16432,51707,258531,42.309853,-71.101719,195000,CONDOMINIUM,FREE-STANDNG
606006,64530,541476,1353689,42.357497,-71.130106,1150000,2-FAM RES,TWO FAMILY
138024,33285,104739,523691,42.345991,-71.073071,395000,CONDOMINIUM,ROW-MIDDLE
132003,31833,100170,500847,42.321636,-71.058671,370000,1-FAM RES,COLONIAL
468550,102143,366407,1652044,42.363779,-71.056674,1285000,CONDOMINIUM,ROW-MIDDLE
468550,102143,366407,1652044,42.363779,-71.056674,1285000,CONDOMINIUM,ROW-MIDDLE
468550,102143,366407,1652044,42.363779,-71.056674,1285000,CONDOMINIUM,ROW-MIDDLE
468550,102143,366407,1652044,42.363779,-71.056674,1285000,CONDOMINIUM,ROW-MIDDLE
183296,44203,139093,695462,42.27764,-71.15892,490000,1-FAM RES,COLONIAL
114906,83861,31045,1086569,42.315495,-71.094473,875000,3-FAM RES,ROW-MIDDLE
151022,36340,114682,572083,42.286461,-71.074648,431500,3-FAM RES,DECKER
97248,23452,73796,368978,42.331124,-71.0557,287000,CONDOMINIUM,DECKER
187740,58283,129457,863046,42.283369,-71.159442,695000,1-FAM RES,COLONIAL
523659,126285,397374,1986869,42.349621,-71.067874,1600000,9 + UNIT APT,CONDO/APT
63246,15252,47994,239970,42.319602,-71.080742,181000,2-FAM RES,CONVENTIONAL
211803,60217,151586,757930,42.237556,-71.130584,625000,1-FAM RES,COLONIAL
816566,51437,765129,1412545,42.322718,-71.113156,1200000,CONDOMINIUM,FREE-STANDNG
405185,73734,331451,1259511,42.351267,-71.146209,950000,2-FAM RES,DUPLEX
333509,80428,253081,1265405,42.358653,-71.141599,1075000,2-FAM RES,CONVENTIONAL
800051,192939,607112,3035556,42.337713,-71.029182,2700000,4-8 UNIT APT,CONDO/APT
142527,34371,108156,540778,42.314834,-71.115098,481000,CONDOMINIUM,LOW-RISE
117340,28297,89043,445214,42.301545,-71.110182,396000,CONDOMINIUM,LOW-RISE
999402,192358,807044,3228174,42.354329,-71.076986,2200000,CONDOMINIUM,HIGH-RISE
601488,145054,456434,2282168,42.354329,-71.076986,1800000,CONDOMINIUM,HIGH-RISE
201395,48568,152827,764131,42.35455,-71.075815,585000,CONDOMINIUM,HIGH-RISE
926196,223360,702836,3514177,42.35455,-71.075815,2950000,CONDOMINIUM,HIGH-RISE
926196,223360,702836,3514177,42.354329,-71.076986,2950000,CONDOMINIUM,HIGH-RISE
651098,157018,494080,2470398,42.35455,-71.075815,1825000,CONDOMINIUM,HIGH-RISE
38563,9299,29264,146318,42.339397,-71.048689,97000,3-FAM RES,SEMI DETACHD
355578,85750,269828,1349136,42.35166,-71.079853,1200000,CONDOMINIUM,MID-RISE
220085,42589,177496,713556,42.246837,-71.118992,599000,3-FAM RES,CONVENTIONAL
529898,101991,427907,1711626,42.365972,-71.0577,1350000,3-FAM RES,CONDO/APT
1291700,248958,1042742,4176273,42.352461,-71.079763,3150000,CONDOMINIUM,ROW-MIDDLE
471019,90658,380361,1521445,42.382008,-71.013368,1200000,2-FAM RES,CONDO/APT
2034336,233161,1801175,4735878,42.352563,-71.080098,3227500,CONDOMINIUM,ROW-MIDDLE
173128,68364,104764,965239,42.286523,-71.079412,820000,3-FAM RES,DECKER
59262,14291,44971,224855,42.244057,-71.138385,200000,2-FAM RES,CONVENTIONAL
414841,100042,314799,1573992,42.243679,-71.139151,1400000,3-FAM RES,CONVENTIONAL
593755,92857,500898,1669659,42.331324,-71.03854,1300000,3-FAM RES,DECKER
316232,76262,239970,1199850,42.329481,-71.101584,905000,RES UDV LAND,CONVENTIONAL
927592,223697,703895,3519472,42.286313,-71.138208,2600000,9 + UNIT APT,CONDO/APT
148157,35729,112428,562140,42.36916,-71.036938,500000,3-FAM RES,ROW-MIDDLE
304958,73543,231415,1157074,42.323462,-71.060195,900000,3-FAM RES,DECKER
490646,94436,396210,1584839,42.382186,-71.013432,1250000,2-FAM RES,TWO FAMILY
195042,30219,164823,545184,42.30925,-71.064769,430000,3-FAM RES,DECKER
344929,66389,278540,1114159,42.352421,-71.079914,785000,CONDOMINIUM,ROW-MIDDLE
229644,55380,174264,871316,42.37417,-71.035562,775000,3-FAM RES,DECKER
216468,52203,164265,821322,42.346433,-71.147206,465000,2-FAM RES,TWO FAMILY
61324,14788,46536,232678,42.339262,-71.151932,175500,CONDOMINIUM,ROW-END
1076458,112358,964100,2378301,42.339269,-71.152535,1849900,4-8 UNIT APT,CONDO/APT
365483,88139,277344,1386716,42.33905,-71.152071,820000,9 + UNIT APT,CONDO/APT
280998,67765,213233,1066165,42.374729,-71.037211,895000,3-FAM RES,CONVENTIONAL
49947,12045,37902,189510,42.341379,-71.154775,140000,CONDOMINIUM,LOW-RISE
69708,19818,49889,249449,42.375616,-71.035369,170000,3-FAM RES,ROW-MIDDLE
252847,60976,191871,959353,42.368564,-71.035336,815000,3-FAM RES,ROW-MIDDLE
125484,30261,95223,476112,42.336742,-71.051416,364500,CONDOMINIUM,ROW-END
348063,66992,281071,1124280,42.336856,-71.037464,1000000,2-FAM RES,ROW-MIDDLE
276814,66756,210058,1050290,42.339122,-71.152606,740000,GEN OFFICE,RAISED CAPE
163869,39518,124351,621755,42.304622,-71.069361,476000,3-FAM RES,CONVENTIONAL
446225,154403,291822,2235228,42.347661,-71.138159,1800000,3-FAM RES,ROW-MIDDLE
307649,74192,233457,1167285,42.335128,-71.038197,940000,2-FAM RES,ROW-MIDDLE
78548,18942,59606,298030,42.279427,-71.098206,240000,1-FAM RES,CONVENTIONAL
83540,20146,63394,316967,42.374752,-71.037183,250000,3-FAM RES,CONDO/APT
248949,60036,188913,944564,42.369061,-71.036711,745000,3-FAM RES,ROW-END
200495,48351,152144,760722,42.304729,-71.06885,600000,MXU COM+RES,RAISED CAPE
65466,15787,49679,248393,42.338245,-71.152599,183500,CONDOMINIUM,LOW-RISE
339177,47322,291855,887478,42.338386,-71.153192,745000,CONDOMINIUM,LOW-RISE
226236,83287,142949,1191246,42.374511,-71.033583,1000000,MXU COM+RES,RAISED CAPE
1294433,312164,982269,4911342,42.343029,-71.076525,3760000,1-FAM RES,ROW-MIDDLE
153415,36997,116418,582090,42.282384,-71.143621,480000,1-FAM RES,COLONIAL
1456044,179987,1276057,3541481,42.316414,-71.107347,3150000,4-8 UNIT APT,CONDO/APT
64217,15486,48731,243655,42.323615,-71.056705,180000,CONDOMINIUM,DECKER
174886,42175,132711,663555,42.308616,-71.063269,475000,3-FAM RES,DECKER
193295,46614,146681,733403,42.291862,-71.134327,525000,CONDOMINIUM,DECKER
193295,46614,146681,733403,42.291862,-71.134327,525000,CONDOMINIUM,DECKER
193295,46614,146681,733403,42.291862,-71.134327,525000,CONDOMINIUM,DECKER
856927,206655,650272,3251357,42.353653,-71.053436,2300000,CONDOMINIUM,HIGH-RISE
401692,68143,333549,1191246,42.299989,-71.053116,1000000,2-FAM RES,CONVENTIONAL
872135,144521,727614,2546647,42.34287,-71.068244,2100000,1-FAM RES,ROW-MIDDLE
606502,146263,460239,2301193,42.258321,-71.118752,1700000,9 + UNIT APT,CONDO/APT
371864,89678,282186,1410929,42.338412,-71.152271,1010000,3-FAM RES,CONVENTIONAL
61438,14816,46622,233108,42.322527,-71.071811,164900,2-FAM RES,TWO FAMILY
511393,110793,400600,1795109,42.319763,-71.055718,1525000,2-FAM RES,SEMI DETACHD
511393,110793,400600,1795109,42.319867,-71.0557,1525000,2-FAM RES,SEMI DETACHD
207216,49972,157244,786222,42.312499,-71.071757,660000,3-FAM RES,DECKER
713816,66400,647416,1483172,42.313363,-71.100176,1260000,3-FAM RES,SEMI DETACHD
287185,25944,261241,587793,42.365178,-71.052876,450000,2-FAM RES,ROW-MIDDLE
84344,20340,64004,320020,42.33989,-71.144763,245000,CONDOMINIUM,LOW-RISE
234830,56631,178199,890991,42.3312,-71.031171,792500,CONDOMINIUM,SEMI DETACHD
310242,74817,235425,1177121,42.379989,-71.067439,1000000,1-FAM RES,COLONIAL
452953,109233,343720,1718596,42.345575,-71.071455,1460000,CONDOMINIUM,ROW-MIDDLE
380934,91865,289069,1445341,42.343522,-71.06983,985000,1-FAM RES,ROW-MIDDLE
271462,65465,205997,1029981,42.287296,-71.087569,875000,3-FAM RES,DECKER
303723,73245,230478,1152387,42.260833,-71.113513,1025000,4-8 UNIT APT,CONDO/APT
3443,830,2613,13062,42.274306,-71.072085,10000,CONDOMINIUM,FREE-STANDNG
202798,48906,153892,769458,42.320799,-71.06041,455000,3-FAM RES,DECKER
287654,69370,218284,1091420,42.31279,-71.064067,900000,3-FAM RES,DECKER
573947,138412,435535,2177674,42.366302,-71.056365,1850000,4-8 UNIT APT,CONDO/APT
1143786,178877,964909,3216365,42.360909,-71.066099,2700000,9 + UNIT APT,CONDO/APT
152853,36861,115992,579956,42.363885,-71.056417,444000,9 + UNIT APT,CONDO/APT
306819,73992,232827,1164133,42.33771,-71.029424,860000,3-FAM RES,SEMI DETACHD
1295542,150499,1145043,3039312,42.342866,-71.087298,2150000,4-8 UNIT APT,CONDO/APT
1111770,150499,961271,2855540,42.342866,-71.087298,2020000,4-8 UNIT APT,CONDO/APT
187509,32009,155500,558385,42.266153,-71.119623,395000,1-FAM RES,RANCH
382925,92345,290580,1452898,42.27714,-71.097633,1170000,3-FAM RES,ROW-END
119856,28904,90952,454758,42.294458,-71.073004,375000,1-FAM RES,CAPE COD
68730,16574,52156,260776,42.294458,-71.073004,210000,1-FAM RES,CAPE COD
84626,20408,64218,321088,42.302483,-71.072581,250000,2-FAM RES,SEMI DETACHD
84626,20408,64218,321088,42.302482,-71.072703,250000,2-FAM RES,SEMI DETACHD
2013225,214377,1798848,4497120,42.319763,-71.055718,4000000,2-FAM RES,SEMI DETACHD
2013225,214377,1798848,4497120,42.319867,-71.0557,4000000,2-FAM RES,SEMI DETACHD
651893,157209,494684,2473416,42.32046,-71.054674,2200000,4-8 UNIT APT,CONDO/APT
271673,65516,206157,1030785,42.272604,-71.078466,850000,2-FAM RES,CONVENTIONAL
206310,49753,156557,782785,42.272604,-71.078466,665000,2-FAM RES,CONVENTIONAL
136227,32852,103375,516875,42.283979,-71.092525,370000,RES UDV LAND,DECKER
271835,217264,54571,2789184,42.347586,-71.138017,2300000,4-8 UNIT APT,CONDO/APT
115963,27965,87998,439986,42.331626,-71.035155,310000,CONDOMINIUM,ROW-END
267574,64527,203047,1015232,42.351033,-71.080112,750000,CONDOMINIUM,ROW-MIDDLE
403954,97417,306537,1532684,42.339654,-71.079691,1263873,CONDOMINIUM,MID-RISE
307714,74208,233506,1167530,42.351033,-71.080112,750000,CONDOMINIUM,ROW-MIDDLE
1805257,435354,1369903,6849513,42.353145,-71.077656,4400000,CONDOMINIUM,ROW-MIDDLE
1805257,435354,1369903,6849513,42.352775,-71.079293,4400000,CONDOMINIUM,MID-RISE
338485,81628,256857,1284283,42.352775,-71.079293,825000,CONDOMINIUM,MID-RISE
220375,53145,167230,836149,42.317507,-71.098478,710334,3-FAM RES,ROW-MIDDLE
224925,54242,170683,853412,42.317417,-71.098476,725000,3-FAM RES,ROW-MIDDLE
148157,35729,112428,562140,42.242974,-71.143616,500000,1-FAM RES,COLONIAL
1854587,447250,1407337,7036685,42.351579,-71.080514,5550000,CONDOMINIUM,MID-RISE
1854587,447250,1407337,7036685,42.351579,-71.080514,5550000,CONDOMINIUM,MID-RISE
296191,71429,224762,1123809,42.351579,-71.080514,875000,CONDOMINIUM,MID-RISE
657541,84545,572996,1637130,42.365876,-71.03122,1350000,3-FAM RES,ROW-END
218659,52731,165928,829640,42.336615,-71.037579,550000,CONDOMINIUM,FREE-STANDNG
242908,58579,184329,921643,42.358925,-71.1404,760000,2-FAM RES,CONVENTIONAL
287654,69370,218284,1091420,42.361943,-71.142845,900000,2-FAM RES,TWO FAMILY
433655,104579,329076,1645376,42.370789,-71.032325,1325000,4-8 UNIT APT,CONDO/APT
123052,29675,93377,466885,42.286228,-71.064035,385000,CONDOMINIUM,MID-RISE
275783,45891,229892,807505,42.233695,-71.133383,686000,2-FAM RES,TWO FAMILY
252111,186800,65311,2416485,42.354249,-71.076575,1850000,CONDOMINIUM,ROW-MIDDLE
30812,8760,22052,110263,42.286339,-71.079715,78000,2-FAM RES,TWO FAMILY
122299,29493,92806,464030,42.28454,-71.064759,350000,MXU RES+COM,RAISED CAPE
293842,93603,200239,1378390,42.314554,-71.101546,1110000,3-FAM RES,DECKER
134666,32475,102191,510951,42.369917,-71.03298,360000,3-FAM RES,CONDO/APT
517113,124706,392407,1962033,42.374239,-71.036855,1580000,1-FAM RES,CONDO/APT
406204,97959,308245,1541224,42.332004,-71.109315,1200000,3-FAM RES,DECKER
626858,151172,475686,2378430,42.366532,-71.054771,1850000,4-8 UNIT APT,CONDO/APT
500691,102143,398548,1684185,42.318285,-71.077694,1310000,MXU RES+COM,RAISED CAPE
500691,102143,398548,1684185,42.318036,-71.077735,1310000,MXU RES+COM,RAISED CAPE
434408,104761,329647,1648232,42.284436,-71.06479,1300000,OTHER EXEMPT,CONDO/APT
1704525,328076,1376449,5505797,42.351052,-71.080392,3650000,9 + UNIT APT,CONDO/APT
412976,79487,333489,1333957,42.31024,-71.061079,1100000,CONDOMINIUM,DECKER
412976,79487,333489,1333957,42.31024,-71.061079,1100000,CONDOMINIUM,DECKER
412976,79487,333489,1333957,42.31024,-71.061079,1100000,CONDOMINIUM,DECKER
33645,8113,25532,127659,42.31024,-71.061079,87000,CONDOMINIUM,DECKER
169,40,129,642,42.31024,-71.061079,500,CONDOMINIUM,DECKER
277055,66814,210241,1051201,42.37418,-71.036763,935000,2-FAM RES,TWO FAMILY
445447,107423,338024,1690117,42.351982,-71.08229,1050000,CONDOMINIUM,ROW-MIDDLE
156230,37676,118554,592770,42.352321,-71.080292,345000,CONDOMINIUM,ROW-MIDDLE
355578,85750,269828,1349136,42.33536,-71.050797,1200000,3-FAM RES,DECKER
497809,120051,377758,1888790,42.3292,-71.100947,1680000,2-FAM RES,TWO FAMILY
360015,86820,273195,1365972,42.340325,-71.053018,1100000,CONDOMINIUM,FREE-STANDNG
360015,86820,273195,1365972,42.340325,-71.053018,1100000,CONDOMINIUM,FREE-STANDNG
283430,68351,215079,1075393,42.373761,-71.05175,866000,CONDOMINIUM,MID-RISE
407840,98354,309486,1547429,42.373761,-71.05175,1299000,CONDOMINIUM,MID-RISE
367559,88640,278919,1394592,42.373761,-71.05175,1150000,CONDOMINIUM,MID-RISE
291627,70328,221299,1106493,42.374322,-71.036438,940000,3-FAM RES,DECKER
2328400,448155,1880245,7520981,42.352375,-71.080813,5850000,BOARDING HSE,ROW-MIDDLE
4344080,1047614,3296466,16482326,42.352375,-71.080813,13000000,BOARDING HSE,ROW-MIDDLE
197295,77836,119459,1099158,42.329482,-71.10132,812000,2-FAM RES,CONVENTIONAL
353676,85292,268384,1341918,42.369067,-71.036248,1140000,3-FAM RES,SEMI DETACHD
71844,17325,54519,272592,42.274461,-71.088409,215000,1-FAM RES,COLONIAL
48453,11684,36769,183841,42.27201,-71.090798,145000,1-FAM RES,COLONIAL
499229,270614,228615,3634720,42.324735,-71.082811,2830000,9 + UNIT APT,CONDO/APT
1648478,316206,1332272,5312223,42.283291,-71.063975,4725000,MXU RES+COM,CONDO/APT
1834152,357145,1477007,5972244,42.353354,-71.071403,4650000,CONDOMINIUM,HIGH-RISE
351833,84847,266986,1334928,42.343217,-71.066414,1075000,CONDOMINIUM,MID-RISE
208662,40244,168418,674959,42.333449,-71.052047,525000,3-FAM RES,SEMI DETACHD
149841,36135,113706,568530,42.342924,-71.086231,420000,CONDOMINIUM,ROW-END
155049,37391,117658,588290,42.366192,-71.06722,390000,CONDOMINIUM,HIGH-RISE
64574,15572,49002,245009,42.340014,-71.158807,181000,CONDOMINIUM,MID-RISE
2414968,582391,1832577,9162882,42.345267,-71.084125,8150000,CONDOMINIUM,HIGH-RISE
149031,35940,113091,565453,42.37704,-71.06244,400000,1-FAM RES,SEMI DETACHD
309931,74742,235189,1175944,42.344222,-71.101666,999000,CONDOMINIUM,HIGH-RISE
283697,88073,195624,1304164,42.300775,-71.074197,1160000,3-FAM RES,DECKER
144042,40952,103090,515452,42.290558,-71.076713,300000,4-8 UNIT APT,CONDO/APT
286245,69030,217215,1086075,42.354576,-71.138688,720000,4-8 UNIT APT,CONDO/APT
298173,71907,226266,1131328,42.36068,-71.143969,750000,3-FAM RES,DECKER
570462,137572,432890,2164449,42.360407,-71.069491,1525000,4-8 UNIT APT,CONDO/APT
50775,12244,38531,192653,42.303538,-71.057858,150000,1-FAM RES,CONVENTIONAL
162443,39174,123269,616344,42.348678,-71.096251,436000,CONDOMINIUM,MID-RISE
150313,36249,114064,570318,42.263884,-71.162981,345000,1-FAM RES,RANCH
736246,177552,558694,2793469,42.353193,-71.063136,2175000,CONDOMINIUM,HIGH-RISE
709485,75549,633936,1584839,42.353193,-71.063136,1250000,CONDOMINIUM,HIGH-RISE
694627,167515,527112,2635557,42.353193,-71.063136,2050000,CONDOMINIUM,HIGH-RISE
977262,235675,741587,3707931,42.35328,-71.062559,3150000,CONDOMINIUM,HIGH-RISE
300739,72525,228214,1141066,42.353193,-71.063136,733000,CONDOMINIUM,HIGH-RISE
128436,30973,97463,487311,42.286923,-71.120991,360000,4-8 UNIT APT,CONDO/APT
380865,76934,303931,1272270,42.332445,-71.099926,900000,MXU RES+COM,RAISED CAPE
2345418,163791,2181627,4243198,42.346605,-71.072299,3499000,1-FAM RES,ROW-END
343651,82874,260777,1303883,42.344091,-71.072116,1050000,CONDOMINIUM,MID-RISE
235582,56812,178770,893849,42.344091,-71.072116,705000,CONDOMINIUM,MID-RISE
566994,136735,430259,2151292,42.353354,-71.071403,1675000,CONDOMINIUM,HIGH-RISE
1613257,389051,1224206,6121030,42.353354,-71.071403,5200000,CONDOMINIUM,HIGH-RISE
2214597,107550,2107047,3460736,42.359316,-71.068136,2940000,2-FAM RES,ROW-MIDDLE
159808,38539,121269,606344,42.316905,-71.077504,500000,3-FAM RES,SEMI DETACHD
310922,74981,235941,1179703,42.310931,-71.047161,950000,1-FAM RES,CONVENTIONAL
189562,45714,143848,719238,42.360284,-71.066532,560000,CONDOMINIUM,ROW-MIDDLE
406204,97959,308245,1541224,42.329764,-71.099143,1200000,3-FAM RES,DECKER
103710,25010,78700,393498,42.275223,-71.149273,350000,1-FAM RES,COLONIAL
413116,99626,313490,1567449,42.343578,-71.069063,1200000,2-FAM RES,ROW-END
764094,81364,682730,1706825,42.351387,-71.138304,1450000,2-FAM RES,CONVENTIONAL
232681,56113,176568,882840,42.366171,-71.032042,750000,2-FAM RES,CONVENTIONAL
150036,36182,113854,569269,42.303218,-71.082951,458425,2-FAM RES,CONVENTIONAL
158318,38179,120139,600692,42.329642,-71.102639,430000,2-FAM RES,CONVENTIONAL
325946,78604,247342,1236708,42.376384,-71.062225,1100000,2-FAM RES,ROW-END
82214,19826,62388,311937,42.272955,-71.143752,265000,CONDOMINIUM,LOW-RISE
272926,65818,207108,1035536,42.365689,-71.055038,765000,CONDOMINIUM,ROW-MIDDLE
166200,40080,126120,630598,42.334472,-71.035276,520000,CONDOMINIUM,LOW-RISE
413209,75925,337284,1292922,42.375031,-71.036854,1150000,3-FAM RES,DECKER
188057,45351,142706,713530,42.318963,-71.099547,555556,3-FAM RES,ROW-END
235473,56786,178687,893434,42.330792,-71.053495,750000,1-FAM RES,CONVENTIONAL
282860,68214,214646,1073229,42.340793,-71.050487,885000,1-FAM RES,ROW-MIDDLE
163437,31457,131980,527920,42.351007,-71.065413,390000,CONDOMINIUM,HIGH-RISE
183788,44322,139466,697329,42.377122,-71.060817,550000,CONDOMINIUM,ROW-MIDDLE
519655,125319,394336,1971677,42.357399,-71.068159,1675000,CONDOMINIUM,ROW-MIDDLE
627869,69062,558807,1428062,42.297386,-71.056334,1150000,2-FAM RES,CONVENTIONAL
511386,123325,388061,1940302,42.349061,-71.157929,1600000,MXU RES+COM,CONDO/APT
425374,64861,360513,1176893,42.349061,-71.157929,901000,MXU RES+COM,CONDO/APT
94640,22823,71817,359083,42.313543,-71.114928,279583,1-FAM RES,COLONIAL
409109,98660,310449,1552241,42.321202,-71.061304,1250000,3-FAM RES,DECKER
1594286,53061,1541225,2209088,42.347047,-71.071972,1720000,1-FAM RES,ROW-END
745453,179772,565681,2828403,42.351007,-71.065413,2200000,CONDOMINIUM,HIGH-RISE
108303,26118,82185,410925,42.32118,-71.107997,225000,3-FAM RES,DECKER
344264,83022,261242,1306208,42.333726,-71.102607,1000000,3-FAM RES,ROW-END
378999,72947,306052,1224206,42.343638,-71.069118,1040000,CONDOMINIUM,ROW-END
14270,3441,10829,54145,42.329567,-71.097539,40000,RES UDV LAND,DECKER
83224,65034,18190,836755,42.357779,-71.066096,690000,2-FAM RES,CONVENTIONAL
184483,35508,148975,595899,42.266487,-71.097156,470000,3-FAM RES,DECKER
65200,15723,49477,247385,42.315012,-71.082047,175000,2-FAM RES,CONVENTIONAL
847106,204287,642819,3214094,42.3611,-71.068119,2500000,1-FAM RES,ROW-MIDDLE
847106,204287,642819,3214094,42.361094,-71.068118,2500000,1-FAM RES,ROW-MIDDLE
72163,17402,54761,273804,42.338579,-71.084077,196000,CONDOMINIUM,LOW-RISE
1178868,158001,1020867,3009568,42.353653,-71.053436,2270000,CONDOMINIUM,HIGH-RISE
89169,42084,47085,576789,42.278489,-71.118009,490000,1-FAM RES,COLONIAL
1636571,394674,1241897,6209485,42.358069,-71.071918,4375000,1-FAM RES,ROW-MIDDLE
1050005,253218,796787,3983934,42.359807,-71.072033,3050000,1-FAM RES,ROW-MIDDLE
606284,146210,460074,2300367,42.365937,-71.05585,1525000,4-8 UNIT APT,CONDO/APT
207750,50100,157650,788247,42.300982,-71.071124,650000,3-FAM RES,DECKER
64217,15486,48731,243655,42.240995,-71.137275,180000,1-FAM RES,RANCH
81487,19651,61836,309177,42.295219,-71.06073,275000,CONDOMINIUM,LOW-RISE
26080,6289,19791,98954,42.326075,-71.074956,70000,1-FAM RES,COLONIAL
115977,27968,88009,440042,42.327136,-71.100339,315000,CONDOMINIUM,DECKER
170994,41236,129758,648788,42.291083,-71.05413,535000,1-FAM RES,RANCH
351833,84847,266986,1334928,42.334389,-71.051424,1075000,1-FAM RES,ROW-END
119443,28804,90639,453191,42.312084,-71.084987,385000,1-FAM RES,COLONIAL
119889,28912,90977,454884,42.366192,-71.06722,325625,CONDOMINIUM,HIGH-RISE
115563,27869,87694,438469,42.330382,-71.112583,390000,CONDOMINIUM,ROW-MIDDLE
111118,26797,84321,421604,42.330382,-71.112583,375000,CONDOMINIUM,ROW-MIDDLE
978236,64527,913709,1725894,42.331282,-71.112658,1275000,CONDOMINIUM,ROW-MIDDLE
978236,64527,913709,1725894,42.331282,-71.112658,1275000,CONDOMINIUM,ROW-MIDDLE
978236,64527,913709,1725894,42.331282,-71.112658,1275000,CONDOMINIUM,ROW-MIDDLE
978236,64527,913709,1725894,42.331282,-71.112658,1275000,CONDOMINIUM,ROW-MIDDLE
978236,64527,913709,1725894,42.331282,-71.112658,1275000,CONDOMINIUM,ROW-MIDDLE
978236,64527,913709,1725894,42.331282,-71.112658,1275000,CONDOMINIUM,ROW-MIDDLE
978236,64527,913709,1725894,42.331282,-71.112658,1275000,CONDOMINIUM,ROW-MIDDLE
114164,27531,86633,433165,42.366192,-71.06722,320000,CONDOMINIUM,HIGH-RISE
92045,22197,69848,349239,42.366192,-71.06722,250000,CONDOMINIUM,HIGH-RISE
138319,39325,98994,494970,42.293624,-71.080457,385000,3-FAM RES,DECKER
343630,82869,260761,1303804,42.346168,-71.072396,810000,1-FAM RES,ROW-MIDDLE
3506359,246650,3259709,6364192,42.340362,-71.078369,5125000,CONDOMINIUM,FREE-STANDNG
112153,27046,85107,425532,42.250769,-71.131027,290000,3-FAM RES,DECKER
394471,54918,339553,1030785,42.371504,-71.041841,850000,MXU COM+RES,RAISED CAPE
423170,102051,321119,1605593,42.316497,-71.057968,1364000,3-FAM RES,CONVENTIONAL
165137,162832,2305,2051811,42.322361,-71.058836,1825000,4-8 UNIT APT,CONDO/APT
159732,30744,128988,515952,42.301695,-71.08512,395000,3-FAM RES,DECKER
523770,40473,483297,992718,42.347308,-71.062825,760000,4-8 UNIT APT,CONDO/APT
127641,30781,96860,484299,42.25985,-71.114426,390000,2-FAM RES,TWO FAMILY
929637,246650,682987,3787470,42.356979,-71.050463,3050000,CONDOMINIUM,HIGH-RISE
5011505,401957,4609548,9668808,42.366344,-71.055942,8600000,9 + UNIT APT,CONDO/APT
1721320,415112,1306208,6531040,42.366344,-71.055942,5000000,9 + UNIT APT,CONDO/APT
309394,59550,249844,999375,42.289508,-71.124096,849000,OTHER EXEMPT,DECKER
811349,156163,655186,2620742,42.365601,-71.054436,2200000,CONDOMINIUM,LOW-RISE
235821,56870,178951,894752,42.351079,-71.169842,685000,2-FAM RES,CONVENTIONAL
220545,53186,167359,836795,42.378166,-71.038644,660000,3-FAM RES,SEMI DETACHD
212919,51347,161572,807858,42.37778,-71.062384,629000,1-FAM RES,CONVENTIONAL
109381,44404,64977,623874,42.391405,-71.001218,530000,1-FAM RES,COLONIAL
127993,63775,64218,866938,42.315479,-71.094492,675000,3-FAM RES,ROW-END
274370,75993,198377,1154868,42.297875,-71.112359,930000,3-FAM RES,CONVENTIONAL
1692618,180237,1512381,3780953,42.341568,-71.081872,3363000,4-8 UNIT APT,CONDO/APT
1428540,344505,1084035,5420172,42.357895,-71.069593,4550000,1-FAM RES,ROW-END
257519,62103,195416,977080,42.283614,-71.087276,760757,CONDOMINIUM,DECKER
257519,62103,195416,977080,42.283614,-71.087276,760757,CONDOMINIUM,DECKER
257519,62103,195416,977080,42.283614,-71.087276,760757,CONDOMINIUM,DECKER
257519,62103,195416,977080,42.283614,-71.087276,760757,CONDOMINIUM,DECKER
257519,62103,195416,977080,42.283614,-71.087276,760757,CONDOMINIUM,DECKER
257519,62103,195416,977080,42.283614,-71.087276,760757,CONDOMINIUM,DECKER
83863,20224,63639,318192,42.319567,-71.08067,240000,2-FAM RES,CONVENTIONAL
198258,47811,150447,752234,42.333958,-71.102463,530000,1-FAM RES,ROW-MIDDLE
23134,6994,16140,104181,42.289508,-71.124096,71000,CONDOMINIUM,DECKER
1325941,132312,1193629,2858991,42.354474,-71.128624,2400000,2-FAM RES,DUPLEX
43019,10374,32645,163226,42.339795,-71.15247,95000,CONDOMINIUM,LOW-RISE
341266,82299,258967,1294833,42.352903,-71.163427,1100000,3-FAM RES,CONVENTIONAL
125586,30286,95300,476498,42.381446,-71.014806,400000,1-FAM RES,COLONIAL
1866535,293602,1572933,5268378,42.31037,-71.06088,3892000,9 + UNIT APT,CONDO/APT
82670,19936,62734,313667,42.331391,-71.039717,221000,CONDOMINIUM,ROW-END
91493,22064,69429,347144,42.331391,-71.039717,248500,CONDOMINIUM,ROW-END
77912,44767,33145,596610,42.293786,-71.155285,450000,2-FAM RES,TWO FAMILY
353676,85292,268384,1341918,42.369018,-71.036135,1140000,3-FAM RES,SEMI DETACHD
284835,62957,221878,1014297,42.342502,-71.083713,800000,CONDOMINIUM,ROW-END
495405,119471,375934,1879668,42.350155,-71.088389,1550000,CONDOMINIUM,ROW-MIDDLE
180735,24815,155920,468257,42.27485,-71.167073,300800,1-FAM RES,CONVENTIONAL
974829,235088,739741,3698701,42.340049,-71.159,3050000,3-FAM RES,ROW-END
260801,62894,197907,989535,42.367283,-71.052961,656000,CONDOMINIUM,MID-RISE
719664,112548,607116,2023720,42.345375,-71.089682,1300000,4-8 UNIT APT,CONDO/APT
249301,60121,189180,945897,42.338026,-71.072592,780000,CONDOMINIUM,MID-RISE
542216,130760,411456,2057277,42.350246,-71.080415,1575000,CONDOMINIUM,MID-RISE
260487,62818,197669,988341,42.350246,-71.080415,815000,CONDOMINIUM,MID-RISE
506569,122163,384406,1922028,42.350246,-71.080415,1495000,CONDOMINIUM,MID-RISE
3075978,169715,2906263,5042395,42.343679,-71.076798,4485000,CONDOMINIUM,FREE-STANDNG
76188,18373,57815,289074,42.250935,-71.120712,228000,1-FAM RES,COLONIAL
134187,32360,101827,509135,42.339075,-71.047424,410000,CONDOMINIUM,MID-RISE
88438,21327,67111,335551,42.328044,-71.077981,261000,2-FAM RES,SEMI DETACHD
66391,16010,50381,251902,42.288526,-71.076468,190000,3-FAM RES,DECKER
973678,234811,738867,3694335,42.353823,-71.062232,2975000,CONDOMINIUM,HIGH-RISE
1876635,138124,1738511,3477022,42.353258,-71.074211,2800000,CONDOMINIUM,ROW-MIDDLE
531760,128238,403522,2017608,42.345021,-71.070212,1375000,CONDOMINIUM,MID-RISE
2481935,598541,1883394,9416969,42.353957,-71.078032,8000000,CONDOMINIUM,ROW-MIDDLE
2481935,598541,1883394,9416969,42.353957,-71.078032,8000000,CONDOMINIUM,ROW-MIDDLE
3777558,100732,3676826,4944697,42.350758,-71.081421,3900000,CONDOMINIUM,ROW-MIDDLE
269110,51796,217314,869255,42.38204,-71.032162,700000,2-FAM RES,TWO FAMILY
504581,121684,382897,1914485,42.33125,-71.035144,1510000,3-FAM RES,DECKER
612326,117856,494470,1977879,42.330684,-71.033093,1560000,1-FAM RES,COLONIAL
437829,268717,169112,3551346,42.350889,-71.080611,2100000,CONDOMINIUM,ROW-MIDDLE
1039310,250639,788671,3943355,42.32668,-71.091075,3350000,SUBSDZ HSNG,DECKER
310242,74817,235425,1177121,42.340114,-71.159491,1000000,CONDOMINIUM,ROW-MIDDLE
1031554,248768,782786,3913927,42.357347,-71.072338,3325000,CONDOMINIUM,MID-RISE
735117,177280,557837,2789184,42.351411,-71.08114,2300000,CONDOMINIUM,ROW-MIDDLE
922281,222416,699865,3499324,42.351438,-71.081035,2760000,CONDOMINIUM,ROW-MIDDLE
332715,200135,132580,2651602,42.362778,-71.055672,2000000,MXU RES+COM,RAISED CAPE
743220,104922,638298,1958914,42.237072,-71.131051,1335000,9 + UNIT APT,CONDO/APT
153062,36912,116150,580748,42.281113,-71.065469,385000,2-FAM RES,CONVENTIONAL
144325,21339,122986,391576,42.322721,-71.104867,277000,CONDOMINIUM,LOW-RISE
319104,76954,242150,1210748,42.379547,-71.032346,975000,3-FAM RES,DECKER
207750,50100,157650,788247,42.375229,-71.034762,650000,3-FAM RES,DECKER
222236,53594,168642,843209,42.282491,-71.151351,750000,2-FAM RES,CONVENTIONAL
294833,71101,223732,1118658,42.341211,-71.079929,995000,CONDOMINIUM,ROW-END
150955,36404,114551,572753,42.356373,-71.156803,410000,2-FAM RES,CONVENTIONAL
266684,64313,202371,1011852,42.333686,-71.049453,900000,1-FAM RES,SEMI DETACHD
277666,66961,210705,1053523,42.365953,-71.031158,895000,3-FAM RES,SEMI DETACHD
101131,24388,76743,383714,42.274341,-71.088519,309000,2-FAM RES,TWO FAMILY
452975,48234,404741,1011852,42.280944,-71.065641,900000,2-FAM RES,CONVENTIONAL
76347,18411,57936,289679,42.312794,-71.07478,214000,3-FAM RES,CONVENTIONAL
555525,106697,448828,1791780,42.340494,-71.080242,1267500,4-8 UNIT APT,CONDO/APT
102723,24772,77951,389751,42.346337,-71.138814,279000,CONDOMINIUM,LOW-RISE
139343,26819,112524,450094,42.237023,-71.130867,355000,1-FAM RES,CONDO/APT
212973,88794,124179,1241793,42.278884,-71.159535,1000000,MXU RES+COM,RAISED CAPE
914948,220648,694300,3471501,42.278849,-71.066349,2100000,CONDOMINIUM,LOW-RISE
440225,106164,334061,1670303,42.319585,-71.06061,1377355,3-FAM RES,DECKER
331869,80033,251836,1259178,42.336127,-71.03756,1014000,3-FAM RES,ROW-MIDDLE
33666,8118,25548,127737,42.341597,-71.051535,90000,COM PDV LAND,CONVENTIONAL
60676,14632,46044,230219,42.333912,-71.051312,176250,1-FAM RES,ROW-MIDDLE
1967940,474586,1493354,7466766,42.353653,-71.053436,4950000,CONDOMINIUM,HIGH-RISE
167095,32310,134785,541457,42.321459,-71.072335,400000,MXU COM+RES,RAISED CAPE
130925,31573,99352,496758,42.27052,-71.094815,350000,2-FAM RES,CONVENTIONAL
184419,44474,139945,699721,42.280347,-71.086915,577000,3-FAM RES,DECKER
150785,36363,114422,572108,42.358102,-71.062597,445000,CONDOMINIUM,MID-RISE
266684,64313,202371,1011852,42.375926,-71.03224,900000,3-FAM RES,DECKER
360081,56313,303768,1012559,42.307128,-71.083648,850000,3-FAM RES,SEMI DETACHD
2683246,282859,2400387,5960609,42.34836,-71.069862,4800000,4-8 UNIT APT,CONDO/APT
285423,68832,216591,1082951,42.343433,-71.081947,920000,CONDOMINIUM,ROW-MIDDLE
213862,51574,162288,811437,42.37868,-71.038805,640000,3-FAM RES,SEMI DETACHD
150338,36255,114083,570415,42.279104,-71.125069,449900,1-FAM RES,CAPE COD
644319,155383,488936,2444679,42.344714,-71.077656,1750000,2-FAM RES,ROW-MIDDLE
1877810,276503,1601307,5081535,42.344714,-71.077656,3832803,2-FAM RES,ROW-MIDDLE
222236,53594,168642,843209,42.334329,-71.044845,750000,1-FAM RES,COLONIAL
100154,55157,44997,739241,42.379609,-71.038299,575000,3-FAM RES,SEMI DETACHD
443956,107064,336892,1684460,42.322406,-71.058967,1431000,3-FAM RES,DECKER
1345009,210347,1134662,3782207,42.34999,-71.06795,3175000,CONDOMINIUM,TOWNHOUSE
217051,49615,167436,791929,42.320773,-71.060302,525000,3-FAM RES,DECKER
435372,23380,411992,706272,42.376108,-71.037701,600000,2-FAM RES,SEMI DETACHD
703748,169715,534033,2670165,42.360288,-71.065957,2375000,1-FAM RES,ROW-MIDDLE
149382,23390,125992,420403,42.286238,-71.045345,327000,CONDOMINIUM,FREE-STANDNG
261851,63147,198704,993517,42.347341,-71.05033,700000,CONDOMINIUM,MID-RISE
266684,64313,202371,1011852,42.341673,-71.151395,900000,3-FAM RES,ROW-END
126005,30387,95618,478090,42.373328,-71.061249,385000,CONDOMINIUM,TOWNHOUSE
366354,130930,235424,1883393,42.291749,-71.122463,1600000,4-8 UNIT APT,CONDO/APT
2531071,47322,2483749,3079372,42.331766,-71.042591,2585000,3-FAM RES,DECKER
643158,155103,488055,2440271,42.347341,-71.05033,1900000,CONDOMINIUM,MID-RISE
1250572,44791,1205781,1769555,42.347341,-71.05033,1425000,CONDOMINIUM,MID-RISE
470947,113573,357374,1786869,42.377449,-71.038252,1500000,3-FAM RES,CONDO/APT
583271,21509,561762,832490,42.351397,-71.1413,615000,2-FAM RES,CONVENTIONAL
155999,37620,118379,591891,42.293477,-71.163951,350000,1-FAM RES,COLONIAL
139529,33648,105881,529403,42.358697,-71.140383,373000,CONDOMINIUM,DUPLEX
718000,173152,544848,2724238,42.355213,-71.062168,1750000,GEN OFFICE,CONDO/APT
1003117,241910,761207,3806032,42.354019,-71.078159,3195000,CONDOMINIUM,ROW-MIDDLE
1003117,241910,761207,3806032,42.354019,-71.078159,3195000,CONDOMINIUM,ROW-MIDDLE
98875,39285,59590,554059,42.336189,-71.03732,437000,CONDOMINIUM,FREE-STANDNG
0,0,0,1,42.336189,-71.03732,1,CONDOMINIUM,FREE-STANDNG
837090,201871,635219,3176091,42.339999,-71.079895,2825000,4-8 UNIT APT,CONDO/APT
2160780,332089,1828691,6008557,42.34974,-71.130708,4600000,MXU RES+COM,CONDO/APT
242192,58406,183786,918927,42.378935,-71.031885,740000,3-FAM RES,DECKER
240556,58012,182544,912718,42.332866,-71.052229,735000,1-FAM RES,ROW-END
7016425,830224,6186201,16635866,42.35133,-71.081454,12736000,1-FAM RES,ROW-MIDDLE
314147,68272,245875,1105196,42.333218,-71.050263,890000,1-FAM RES,SEMI DETACHD
574301,138497,435804,2179017,42.366097,-71.051114,1485000,CONDOMINIUM,ROW-MIDDLE
170997,53085,117912,786080,42.33536,-71.050797,620000,CONDOMINIUM,LOW-RISE
1330271,45918,1284353,1862312,42.345314,-71.077252,1450000,CONDOMINIUM,ROW-MIDDLE
1582683,381678,1201005,6005021,42.336138,-71.051341,3495000,CONDOMINIUM,DECKER
299693,72273,227420,1137099,42.31732,-71.089952,966000,2-FAM RES,CONVENTIONAL
343651,82874,260777,1303883,42.353972,-71.078326,1050000,CONDOMINIUM,ROW-MIDDLE
801853,193374,608479,3042394,42.353972,-71.078326,2450000,CONDOMINIUM,ROW-MIDDLE
606880,94644,512236,1703482,42.336131,-71.037318,1430000,3-FAM RES,SEMI DETACHD
220905,89047,131858,1252656,42.336131,-71.037318,988000,3-FAM RES,SEMI DETACHD
104828,25280,79548,397740,42.379299,-71.033012,300000,CONDOMINIUM,CONVENTIONAL
26400,6366,20034,100169,42.366536,-71.03635,74000,CONDOMINIUM,DECKER
102570,24735,77835,389172,42.365876,-71.03122,287500,3-FAM RES,ROW-END
94990,22907,72083,360415,42.38144,-71.037528,258000,3-FAM RES,DECKER
2582,622,1960,9796,42.377699,-71.031079,7500,3-FAM RES,SEMI DETACHD
214116,49717,164399,790177,42.345143,-71.076804,596000,CONDOMINIUM,ROW-MIDDLE
253034,61021,192013,960062,42.377485,-71.033736,735000,3-FAM RES,SEMI DETACHD
399520,96347,303173,1515861,42.333245,-71.051819,1250000,2-FAM RES,CONVENTIONAL
500958,62377,438581,1223693,42.351219,-71.081508,904000,CONDOMINIUM,ROW-MIDDLE
1091675,263267,828408,4142040,42.353949,-71.078409,3225000,CONDOMINIUM,ROW-MIDDLE
61722,14884,46838,234186,42.301874,-71.064322,165000,3-FAM RES,DECKER
762395,183858,578537,2892685,42.345453,-71.061615,2250000,GEN OFFICE,CONDO/APT
176021,42449,133572,667863,42.37772,-71.031021,520000,3-FAM RES,SEMI DETACHD
1192691,287628,905063,4525313,42.350017,-71.081233,3000000,MXU COM+RES,CONDO/APT
209413,50501,158912,794556,42.380549,-71.036099,675000,2-FAM RES,TWO FAMILY
240984,58115,182869,914345,42.374972,-71.036005,700000,4-8 UNIT APT,CONDO/APT
89191,21509,67682,338410,42.374844,-71.034929,250000,3-FAM RES,DECKER
284343,68571,215772,1078857,42.374972,-71.036005,840000,4-8 UNIT APT,CONDO/APT
935647,225639,710008,3550039,42.358125,-71.062544,2800000,CONDOMINIUM,MID-RISE
128133,101454,26679,1303640,42.377742,-71.030964,1075000,3-FAM RES,DECKER
220275,62626,157649,788247,42.250505,-71.116293,650000,2-FAM RES,TWO FAMILY
279350,79421,199928,999643,42.330669,-71.039938,805000,2-FAM RES,SEMI DETACHD
204999,49437,155562,777810,42.368544,-71.035528,605000,3-FAM RES,DECKER
78310,48963,29347,645634,42.351335,-71.153604,440000,2-FAM RES,CONVENTIONAL
165730,11658,154072,300807,42.314978,-71.077326,205000,3-FAM RES,DECKER
54447,42361,12086,545275,42.289557,-71.058419,485000,1-FAM RES,ROW-MIDDLE
3880858,388458,3492400,8381758,42.353653,-71.053436,6000000,CONDOMINIUM,HIGH-RISE
82256,19836,62420,312097,42.284978,-71.096012,243000,1-FAM RES,COLONIAL
271462,65465,205997,1029981,42.297495,-71.086307,875000,3-FAM RES,DECKER
29111,7020,22091,110454,42.321983,-71.07196,86000,1-FAM RES,COLONIAL
958849,231235,727614,3638067,42.332832,-71.071378,3000000,1-FAM RES,ROW-MIDDLE
182234,43947,138287,691432,42.294159,-71.081752,615000,3-FAM RES,CONVENTIONAL
129930,22161,107769,386700,42.32012,-71.05595,305000,CONDOMINIUM,DECKER
246171,59366,186805,934024,42.317508,-71.107851,600000,3-FAM RES,DECKER
635982,122409,513573,2054292,42.344836,-71.074333,1400000,2-FAM RES,ROW-MIDDLE
251083,130233,120850,1760038,42.33087,-71.098395,1369000,3-FAM RES,DECKER
67700,16326,51374,256870,42.312673,-71.097618,200000,2-FAM RES,CONVENTIONAL
1898264,457783,1440481,7202402,42.364717,-71.052802,5800000,MXU COM+RES,CONDO/APT
478816,35714,443102,892625,42.333151,-71.048127,695000,CONDOMINIUM,FREE-STANDNG
687228,165731,521497,2607485,42.360786,-71.064351,1675000,BOARDING HSE,CONDO/APT
121494,23384,98110,392437,42.281385,-71.091379,296000,3-FAM RES,DECKER
184867,44582,140285,701423,42.324915,-71.057581,465000,3-FAM RES,DECKER
400272,77041,323231,1292922,42.319876,-71.065971,1150000,3-FAM RES,DECKER
249549,74078,175471,1107859,42.290612,-71.065667,930000,3-FAM RES,DECKER
197958,131668,66290,1723541,42.343474,-71.074063,1300000,1-FAM RES,SEMI DETACHD
178959,43157,135802,679010,42.367775,-71.038069,570000,2-FAM RES,TWO FAMILY
284458,68599,215859,1079293,42.369984,-71.040129,890000,2-FAM RES,SEMI DETACHD
142161,31133,111028,502890,42.322559,-71.078061,385000,2-FAM RES,CONVENTIONAL
83761,20199,63562,317808,42.322559,-71.078061,227500,2-FAM RES,CONVENTIONAL
50297,12129,38168,190840,42.377148,-71.037213,135000,2-FAM RES,SEMI DETACHD
480875,115967,364908,1824537,42.375435,-71.058075,1550000,3-FAM RES,DECKER
123025,76485,46540,1009225,42.315629,-71.060073,785000,3-FAM RES,DECKER
33059,29906,3153,379571,42.244062,-71.122895,313000,1-FAM RES,CAPE COD
236515,57037,179478,897389,42.288314,-71.070178,740000,2-FAM RES,CONVENTIONAL
2347473,566114,1781359,8906795,42.357984,-71.069643,7025000,1-FAM RES,ROW-MIDDLE
92948,22415,70533,352663,42.285337,-71.058721,266000,1-FAM RES,COLONIAL
188574,45476,143098,715486,42.385283,-71.018656,590000,2-FAM RES,TWO FAMILY
341889,82449,259440,1297197,42.358783,-71.14047,1010000,3-FAM RES,CONVENTIONAL
156369,37709,118660,593296,42.317436,-71.055464,447500,2-FAM RES,CONVENTIONAL
41236,9944,31292,156459,42.305377,-71.069637,112000,2-FAM RES,DUPLEX
274169,77911,196258,1176893,42.331361,-71.108449,901000,2-FAM RES,DECKER
51545,12430,39115,195574,42.284669,-71.096094,140000,2-FAM RES,TWO FAMILY
384371,92694,291677,1458381,42.352207,-71.068581,1100000,CONDOMINIUM,HIGH-RISE
3528706,850979,2677727,13388633,42.352207,-71.068581,10250000,CONDOMINIUM,HIGH-RISE
3057515,737347,2320168,11600837,42.352207,-71.068581,6351968,CONDOMINIUM,HIGH-RISE
295645,71297,224348,1121737,42.373844,-71.033285,925000,3-FAM RES,DECKER
218368,42030,176338,705352,42.333065,-71.050539,540000,2-FAM RES,SEMI DETACHD
67274,52252,15022,672697,42.377695,-71.033715,515000,3-FAM RES,DECKER
208279,50228,158051,790255,42.274196,-71.160508,605000,2-FAM RES,TWO FAMILY
351970,100067,251902,1259511,42.314844,-71.108181,950000,1-FAM RES,CONVENTIONAL
2543114,613295,1929819,9649097,42.350624,-71.081569,8100000,4-8 UNIT APT,CONDO/APT
354096,85393,268703,1343514,42.332885,-71.05191,1195000,3-FAM RES,SEMI DETACHD
310386,74852,235534,1177669,42.353939,-71.077741,870000,CONDOMINIUM,ROW-MIDDLE
3687949,709832,2978117,11912466,42.351154,-71.082081,10000000,MXU RES+COM,RAISED CAPE
397564,95876,301688,1508437,42.340886,-71.080658,1000000,1-FAM RES,SEMI DETACHD
574073,111869,462204,1870257,42.301967,-71.077594,1570000,3-FAM RES,ROW-MIDDLE
1198039,58016,1140023,1870257,42.301913,-71.077539,1570000,RES UDV LAND,ROW-MIDDLE
574073,111869,462204,1870257,42.301862,-71.077488,1570000,3-FAM RES,ROW-MIDDLE
175820,42400,133420,667098,42.277905,-71.146619,560000,1-FAM RES,COLONIAL
251172,60572,190600,952997,42.37929,-71.031481,800000,1-FAM RES,CONDO/APT
87356,21066,66290,331450,42.32739,-71.10826,250000,CONDOMINIUM,MID-RISE
184810,100489,84321,1349136,42.332863,-71.051886,1200000,3-FAM RES,CONVENTIONAL
746726,69905,676821,1556689,42.343334,-71.064146,1150000,4-8 UNIT APT,CONDO/APT
425409,102591,322818,1614087,42.340934,-71.080725,1100000,4-8 UNIT APT,SEMI DETACHD
597215,144023,453192,2265958,42.33043,-71.035362,1925000,3-FAM RES,DECKER
293268,92584,200684,1366000,42.332333,-71.052574,1215000,3-FAM RES,SEMI DETACHD
527366,127179,400187,2000936,42.330142,-71.03306,1650000,3-FAM RES,SEMI DETACHD
106727,92673,14054,1180494,42.333921,-71.03619,1050000,2-FAM RES,SEMI DETACHD
329663,79501,250162,1250808,42.333484,-71.04651,1050000,2-FAM RES,SEMI DETACHD
516277,124504,391773,1958861,42.352033,-71.081381,1545000,CONDOMINIUM,ROW-MIDDLE
235570,56809,178761,893802,42.332863,-71.051886,795000,3-FAM RES,CONVENTIONAL
466640,112534,354106,1770526,42.347277,-71.148955,1460000,2-FAM RES,TWO FAMILY
185239,44672,140567,702835,42.336167,-71.050168,590000,1-FAM RES,COLONIAL
622262,150064,472198,2360988,42.379317,-71.03141,2100000,4-8 UNIT APT,CONDO/APT
275682,66483,209199,1045993,42.374884,-71.035787,825000,RES UDV LAND,CONDO/APT
68829,16598,52231,261153,42.301862,-71.077488,184000,3-FAM RES,ROW-MIDDLE
44889,10825,34064,170317,42.279963,-71.081626,120000,2-FAM RES,CONVENTIONAL
171714,155334,16380,1971513,42.329127,-71.100871,1655000,3-FAM RES,DECKER
158361,38190,120171,600855,42.37785,-71.030676,460000,3-FAM RES,DECKER
92072,26176,65895,329476,42.281024,-71.121401,243400,CONDOMINIUM,TOWNHOUSE
144591,34869,109722,548607,42.301808,-71.077429,420000,3-FAM RES,ROW-MIDDLE
101299,24429,76870,384349,42.346623,-71.136586,289900,CONDOMINIUM,LOW-RISE
653524,157603,495921,2479603,42.348934,-71.074349,1775000,CONDOMINIUM,HIGH-RISE
182975,44126,138849,694244,42.353283,-71.063135,540000,CONDOMINIUM,MID-RISE
263705,63594,200111,1000552,42.309346,-71.067727,850000,3-FAM RES,DECKER
3140,757,2383,11912,42.375995,-71.032162,10000,RES UDV LAND,DECKER
296213,60789,235424,1000552,42.310098,-71.090791,850000,2-FAM RES,TWO FAMILY
90557,21838,68719,343593,42.318594,-71.071848,271000,1-FAM RES,CONVENTIONAL
127846,30831,97015,485075,42.318594,-71.071848,400000,1-FAM RES,CONVENTIONAL
148916,35912,113004,565016,42.262905,-71.156244,455000,1-FAM RES,RANCH
186289,44925,141364,706816,42.287853,-71.145226,500000,1-FAM RES,COLONIAL
172680,41643,131037,655185,42.289535,-71.115124,550000,1-FAM RES,COLONIAL
374168,72017,302151,1208601,42.319509,-71.088166,1075000,3-FAM RES,SEMI DETACHD
255571,61633,193938,969686,42.344729,-71.077679,755000,CONDOMINIUM,ROW-MIDDLE
1551,374,1177,5885,42.300417,-71.052054,5000,CONDOMINIUM,DUPLEX
258955,62449,196506,982530,42.328089,-71.093283,765000,3-FAM RES,SEMI DETACHD
126939,30612,96327,481632,42.288448,-71.061827,375000,3-FAM RES,DECKER
164207,78277,85930,1071180,42.304189,-71.078433,910000,3-FAM RES,CONVENTIONAL
274718,66250,208468,1042340,42.304189,-71.078433,875000,3-FAM RES,CONVENTIONAL
219809,42307,177502,710007,42.261376,-71.162433,560000,1-FAM RES,RANCH
201948,48701,153247,766232,42.290429,-71.146531,548500,1-FAM RES,RAISED RANCH
174713,42133,132580,662900,42.358311,-71.050532,500000,CONDOMINIUM,HIGH-RISE
81322,19611,61711,308553,42.342769,-71.091398,240000,CONDOMINIUM,ROW-END
67464,16269,51195,255973,42.312877,-71.064042,189100,CONDOMINIUM,DECKER
542923,130930,411993,2059962,42.330451,-71.057257,1750000,2-FAM RES,TWO FAMILY
2247295,141645,2105650,3888482,42.342888,-71.087443,2650000,4-8 UNIT APT,CONDO/APT
306832,73995,232837,1164181,42.336299,-71.084192,960000,3-FAM RES,ROW-END
4890671,155667,4735004,6694316,42.358458,-71.069635,5125000,2-FAM RES,ROW-MIDDLE
1063961,143814,920147,2730272,42.353393,-71.07369,1810000,CONDOMINIUM,ROW-MIDDLE
272641,52476,220165,880661,42.328171,-71.088156,685000,3-FAM RES,CONVENTIONAL
263026,63431,199595,997974,42.358848,-71.128173,620000,3-FAM RES,CONVENTIONAL
2789564,224716,2564848,5393251,42.34895,-71.068012,4195000,4-8 UNIT APT,CONDO/APT
172132,41511,130621,653104,42.353788,-71.078993,500000,CONDOMINIUM,ROW-MIDDLE
27614,6659,20955,104771,42.378189,-71.030309,75000,1-FAM RES,CONVENTIONAL
1005511,242488,763023,3815114,42.350523,-71.081953,2600000,CONDOMINIUM,ROW-MIDDLE
295853,56943,238910,955638,42.365953,-71.031158,850000,1-FAM RES,CONVENTIONAL
634114,152922,481192,2405959,42.351242,-71.064743,2140000,MXU COM+RES,RAISED CAPE
1712477,412979,1299498,6497486,42.352121,-71.08177,4800000,1-FAM RES,ROW-MIDDLE
1991847,290747,1701100,5360609,42.368614,-71.03521,4500000,1-FAM RES,CONVENTIONAL
225828,54460,171368,856837,42.368374,-71.035139,690000,2-FAM RES,CONDO/APT
199759,48173,151586,757930,42.368346,-71.035075,625000,1-FAM RES,COLONIAL
266739,64326,202413,1012061,42.368289,-71.034945,815000,1-FAM RES,COLONIAL
144591,34869,109722,548607,42.301761,-71.077372,420000,3-FAM RES,ROW-MIDDLE
536019,129265,406754,2033766,42.353765,-71.079076,1557000,CONDOMINIUM,ROW-MIDDLE
129985,31347,98638,493191,42.263094,-71.10892,384000,3-FAM RES,DECKER
80986,22664,58322,343593,42.303424,-71.075805,271000,1-FAM RES,COLONIAL
122704,40292,82412,589560,42.316588,-71.068433,465000,3-FAM RES,DECKER
18404,15832,2572,201845,42.27727,-71.100991,157000,1-FAM RES,RANCH
125619,35714,89904,449523,42.299309,-71.078165,350000,2-FAM RES,CONVENTIONAL
118476,28571,89905,449523,42.299309,-71.078165,350000,2-FAM RES,CONVENTIONAL
113057,32143,80914,404571,42.317531,-71.078621,315000,2-FAM RES,CONVENTIONAL
4947119,382782,4564337,9382247,42.353827,-71.078158,7400000,9 + UNIT APT,CONDO/APT
266808,64343,202465,1012324,42.377893,-71.030561,860000,3-FAM RES,DECKER
400991,96702,304289,1521445,42.309949,-71.060433,1200000,AUTO REPAIR,CONDO/APT
309471,110601,198870,1590961,42.338489,-71.080479,1200000,3-FAM RES,ROW-MIDDLE
40620,9795,30825,154122,42.338775,-71.048868,120000,RES UDV LAND,DECKER
231898,55924,175974,879868,42.353742,-71.079159,650000,CONDOMINIUM,ROW-END
263760,41249,222511,741704,42.366538,-71.059491,585000,CONDOMINIUM,HIGH-RISE
366047,70454,295593,1182371,42.377914,-71.030503,975000,3-FAM RES,DECKER
61953,14940,47013,235062,42.375592,-71.032037,151000,CONDOMINIUM,DECKER
510271,98213,412058,1648232,42.342345,-71.158559,1300000,3-FAM RES,CONVENTIONAL
527366,127179,400187,2000936,42.304987,-71.073758,1650000,3-FAM RES,SEMI DETACHD
267328,64468,202860,1014297,42.379454,-71.031051,800000,3-FAM RES,SEMI DETACHD
2425138,584844,1840294,9201470,42.349624,-71.08197,6100000,MXU COM+RES,CONDO/APT
1726371,416330,1310041,6550203,42.352075,-71.081943,5100000,4-8 UNIT APT,ROW-MIDDLE
3767416,589189,3178227,10594090,42.352075,-71.081943,9000000,1-FAM RES,ROW-MIDDLE
235578,107143,128435,1477006,42.338709,-71.048769,1150000,3-FAM RES,DECKER
559090,134829,424261,2121302,42.33433,-71.036098,1650000,4-8 UNIT APT,CONDO/APT
111886,26982,84904,424517,42.365604,-71.030132,325000,2-FAM RES,SEMI DETACHD
207750,50100,157650,788247,42.293061,-71.159017,650000,2-FAM RES,COLONIAL
251172,60572,190600,952997,42.364753,-71.03164,800000,3-FAM RES,DECKER
50304,12131,38173,190863,42.377958,-71.030388,141000,1-FAM RES,COLONIAL
45425,10954,34471,172354,42.375165,-71.035461,130000,3-FAM RES,ROW-END
600318,144772,455546,2277729,42.35328,-71.062559,1935000,CONDOMINIUM,HIGH-RISE
2767493,232242,2535251,5458379,42.360436,-71.067794,4855000,MXU RES+COM,CONDO/APT
1205592,155012,1050580,3001658,42.346033,-71.070979,2550000,4-8 UNIT APT,CONDO/APT
267961,111992,155969,1565571,42.320403,-71.055845,1330000,3-FAM RES,DECKER
58199,35716,22483,472025,42.287032,-71.140421,401000,CONDOMINIUM,FREE-STANDNG
399321,59922,339399,1093617,42.292805,-71.062645,725000,4-8 UNIT APT,CONDO/APT
1091079,271214,819865,4233516,42.293413,-71.121234,3596500,9 + UNIT APT,CONDO/APT
38375,9254,29121,145604,42.322846,-71.08192,103000,2-FAM RES,TWO FAMILY
333824,62785,271039,1061294,42.369493,-71.035707,812500,4-8 UNIT APT,CONDO/APT
93460,22538,70922,354610,42.309603,-71.071405,250850,3-FAM RES,DECKER
4738121,629536,4108585,12032285,42.346279,-71.088367,8200000,9 + UNIT APT,CONDO/APT
450546,108653,341893,1709464,42.344572,-71.077805,1165000,CONDOMINIUM,ROW-MIDDLE
37869,9132,28737,143682,42.273548,-71.118058,110000,1-FAM RES,CAPE COD
847363,204349,643014,3215068,42.359298,-71.065172,2425000,MXU RES+COM,CONDO/APT
496955,119845,377110,1885547,42.359298,-71.065172,1250000,MXU RES+COM,CONDO/APT
164831,39750,125081,625404,42.379372,-71.070018,525000,1-FAM RES,ROW-MIDDLE
97482,23508,73974,369870,42.339738,-71.15247,305000,CONDOMINIUM,LOW-RISE
654574,157856,496718,2483587,42.351772,-71.082362,2000000,CONDOMINIUM,ROW-MIDDLE
340497,126544,213953,1806716,42.35429,-71.073087,1425000,CONDOMINIUM,ROW-MIDDLE
424822,102449,322373,1611863,42.35429,-71.073087,1255000,CONDOMINIUM,ROW-MIDDLE
166574,71531,95043,995374,42.353306,-71.170915,775000,2-FAM RES,CONVENTIONAL
69885,16853,53032,265160,42.39157,-71.009077,200000,1-FAM RES,COLONIAL
410451,79000,331451,1325801,42.350845,-71.147702,1000000,4-8 UNIT APT,CONDO/APT
269290,64941,204349,1021741,42.383545,-71.078819,868000,1-FAM RES,SEMI DETACHD
481112,116024,365088,1825436,42.339485,-71.147895,1470000,2-FAM RES,CONDO/APT
601869,145146,456723,2283615,42.339485,-71.147895,1940000,2-FAM RES,CONDO/APT
117049,28227,88822,444110,42.299924,-71.076915,340000,3-FAM RES,DECKER
91395,22040,69355,346775,42.27165,-71.146402,270000,1-FAM RES,CAPE COD
562999,135772,427227,2136132,42.32255,-71.087106,1900000,4-8 UNIT APT,CONDO/APT
258750,40466,218284,727613,42.296512,-71.086786,600000,3-FAM RES,DECKER
188809,28798,160011,522483,42.324924,-71.057258,400000,CONDOMINIUM,FREE-STANDNG
129403,24906,104497,417986,42.324924,-71.057258,320000,CONDOMINIUM,FREE-STANDNG
202192,38916,163276,653104,42.324924,-71.057258,500000,CONDOMINIUM,FREE-STANDNG
140346,33845,106501,532505,42.27248,-71.160652,420000,1-FAM RES,COLONIAL
527367,127179,400188,2000936,42.377695,-71.063729,1650000,2-FAM RES,SEMI DETACHD
48629,11727,36902,184510,42.325744,-71.082305,130000,4-8 UNIT APT,CONDO/APT
310768,74944,235824,1179120,42.355482,-71.143983,930000,3-FAM RES,CONDO/APT
130378,31441,98937,494683,42.281833,-71.084144,440000,3-FAM RES,CONVENTIONAL
711137,59196,651941,1397017,42.294225,-71.080914,1125000,RES UDV LAND,DECKER
711137,59196,651941,1397017,42.294214,-71.080977,1125000,RES UDV LAND,DECKER
711137,59196,651941,1397017,42.294203,-71.081039,1125000,RES UDV LAND,DECKER
113192,27297,85895,429474,42.271618,-71.097163,382000,1-FAM RES,COLONIAL
4994894,1204564,3790330,18951650,42.350422,-71.082337,16100000,4-8 UNIT APT,CONDO/APT
4994894,1204564,3790330,18951650,42.350758,-71.081421,16100000,9 + UNIT APT,CONDO/APT
537579,67448,470131,1319071,42.294997,-71.11701,780000,4-8 UNIT APT,CONDO/APT
80902,19510,61392,306958,42.375205,-71.035414,235000,3-FAM RES,ROW-MIDDLE
8715,2101,6614,33069,42.291299,-71.076252,23300,CTYMUNI PROP,CONDO/APT
67585,16298,51287,256434,42.291507,-71.076719,170000,RES UDV LAND,CONDO/APT
3093904,126929,2966975,4564576,42.344466,-71.080262,4060000,9 + UNIT APT,CONDO/APT
168332,40594,127738,638689,42.285959,-71.08989,450000,4-8 UNIT APT,CONDO/APT
948208,228669,719539,3597695,42.335687,-71.051771,3200000,4-8 UNIT APT,CONDO/APT
615258,156181,459077,2424869,42.335687,-71.051771,2060000,4-8 UNIT APT,CONDO/APT
415500,100201,315299,1576495,42.351884,-71.081941,1300000,CONDOMINIUM,ROW-MIDDLE
105461,43969,61492,614917,42.291643,-71.076522,485000,3-FAM RES,CONVENTIONAL
605481,146017,459464,2297318,42.336164,-71.150366,1850000,CONDOMINIUM,LOW-RISE
779952,95876,684076,1890826,42.333446,-71.154173,1253500,CONDOMINIUM,LOW-RISE
376380,90767,285613,1428062,42.377695,-71.063729,1150000,2-FAM RES,SEMI DETACHD
120297,29010,91287,456433,42.287761,-71.127905,360000,CONDOMINIUM,DECKER
94567,22805,71762,358807,42.314762,-71.093638,283000,CONDOMINIUM,FREE-STANDNG
80902,19510,61392,306958,42.375245,-71.035368,235000,3-FAM RES,ROW-MIDDLE
1286487,94688,1191799,2383597,42.322401,-71.060895,1880000,MXU COM+RES,CONDO/APT
1160208,223309,936899,3747599,42.329633,-71.035216,3333333,1-FAM RES,RANCH
175262,42266,132996,664980,42.388652,-71.001761,535500,2-FAM RES,CONVENTIONAL
170196,41044,129152,645756,42.374776,-71.052581,532500,CONDOMINIUM,MID-RISE
319616,77078,242538,1212689,42.3758,-71.031797,1000000,3-FAM RES,CONDO/APT
203305,49028,154277,771382,42.332886,-71.05116,600000,MXU RES+COM,RAISED CAPE
667175,160895,506280,2531399,42.345384,-71.077174,2125000,CONDOMINIUM,ROW-END
131103,31616,99487,497432,42.351846,-71.082082,339000,CONDOMINIUM,ROW-MIDDLE
165851,94390,71461,1259511,42.328584,-71.101053,950000,2-FAM RES,CONVENTIONAL
677684,163429,514255,2571275,42.339504,-71.051732,2000000,MXU RES+COM,CONDO/APT
210646,75282,135364,1082914,42.328584,-71.101053,800000,2-FAM RES,CONVENTIONAL
2266394,354443,1911951,6373169,42.349656,-71.082592,5350000,MXU COM+RES,RAISED CAPE
342014,82479,259535,1297674,42.357596,-71.127786,1045000,3-FAM RES,SEMI DETACHD
361376,69555,291821,1167285,42.379465,-71.030488,940000,3-FAM RES,DECKER
46912,11313,35599,177995,42.339465,-71.154938,118000,CONDOMINIUM,MID-RISE
221823,53494,168329,841641,42.335792,-71.048753,715000,2-FAM RES,ROW-MIDDLE
612065,147605,464460,2322299,42.353643,-71.078825,1915000,CONDOMINIUM,ROW-MIDDLE
232371,56038,176333,881663,42.374403,-71.033469,749000,3-FAM RES,ROW-MIDDLE
176803,27650,149153,497175,42.301348,-71.076835,375000,3-FAM RES,ROW-END
801984,193405,608579,3042891,42.35337,-71.062515,2400000,CONDOMINIUM,HIGH-RISE
65150,15711,49439,247195,42.264402,-71.101129,210000,CONDOMINIUM,LOW-RISE
21696,5232,16464,82320,42.264402,-71.101129,58000,CONDOMINIUM,LOW-RISE
3338326,805067,2533259,12666294,42.357195,-71.06499,10200000,CONDOMINIUM,ROW-END
2957315,713183,2244132,11220660,42.357195,-71.06499,8850000,CONDOMINIUM,ROW-END
430536,79166,351370,1347803,42.294392,-71.081018,1145000,3-FAM RES,DECKER
5869404,351669,5517735,9944050,42.357195,-71.06499,8200000,CONDOMINIUM,ROW-END
491856,76921,414935,1383117,42.254352,-71.126658,1175000,4-8 UNIT APT,CONDO/APT
170944,41224,129720,648598,42.365144,-71.052756,505000,CONDOMINIUM,ROW-MIDDLE
5747551,1386074,4361477,21807385,42.353346,-71.073873,17200000,CONDOMINIUM,ROW-MIDDLE
400991,96702,304289,1521445,42.332067,-71.105769,1200000,3-FAM RES,DECKER
400991,96702,304289,1521445,42.332019,-71.105742,1200000,3-FAM RES,DECKER
95388,23003,72385,361924,42.311836,-71.070653,255000,3-FAM RES,DECKER
134330,54855,79475,769912,42.293122,-71.072602,620000,3-FAM RES,DECKER
203305,49028,154277,771382,42.378731,-71.038663,600000,3-FAM RES,SEMI DETACHD
442095,106615,335480,1677397,42.368272,-71.036711,1425000,1-FAM RES,COLONIAL
1215407,293106,922301,4611502,42.349359,-71.076991,2525000,CONDOMINIUM,HIGH-RISE
228640,55138,173502,867510,42.349359,-71.076991,475000,CONDOMINIUM,HIGH-RISE
221195,53343,167852,839258,42.335311,-71.044385,620000,CONDOMINIUM,FREE-STANDNG
243323,58679,184644,923216,42.341163,-71.160809,775000,2-FAM RES,TWO FAMILY
253970,61247,192723,963615,42.306983,-71.060006,750273,3-FAM RES,DECKER
464909,89407,375502,1500829,42.317402,-71.059964,1275000,3-FAM RES,DECKER
117823,28414,89409,447045,42.280432,-71.137676,360000,1-FAM RES,COLONIAL
194086,46805,147281,736403,42.373005,-71.062018,655000,CONDOMINIUM,ROW-MIDDLE
109296,26357,82939,414693,42.233379,-71.1294,341962,1-FAM RES,COLONIAL
963268,232300,730968,3654836,42.346697,-71.103109,2700000,GEN OFFICE,CONDO/APT
592631,142918,449713,2248560,42.273257,-71.069923,2000000,4-8 UNIT APT,CONDO/APT
420377,101377,319000,1594999,42.316915,-71.059435,1355000,3-FAM RES,DECKER
82840,19977,62863,314315,42.295069,-71.071477,225000,3-FAM RES,DECKER
361924,69660,292264,1169056,42.359685,-71.067342,895000,CONDOMINIUM,ROW-END
227244,24197,203047,507616,42.360794,-71.06395,375000,CONDOMINIUM,ROW-MIDDLE
53585,12922,40663,203315,42.31359,-71.092089,150199,2-FAM RES,CONVENTIONAL
702409,169392,533017,2665083,42.341727,-71.078074,1712000,4-8 UNIT APT,ROW-MIDDLE
186145,44890,141255,706272,42.292965,-71.157658,600000,1-FAM RES,COLONIAL
286704,69141,217563,1087811,42.30304,-71.083056,876000,3-FAM RES,DECKER
250396,60385,190011,950051,42.334203,-71.102044,669375,1-FAM RES,ROW-MIDDLE
29262,7056,22206,111027,42.32545,-71.081636,85000,2-FAM RES,CONVENTIONAL
352771,61094,291677,1060641,42.328115,-71.093396,800000,4-8 UNIT APT,CONDO/APT
352771,61094,291677,1060641,42.328141,-71.093509,800000,3-FAM RES,SEMI DETACHD
0,0,0,1,42.358962,-71.065993,1,4-8 UNIT APT,CONDO/APT
388614,74797,313817,1255266,42.332443,-71.106455,961000,2-FAM RES,TWO FAMILY
1883788,454292,1429496,7147479,42.348245,-71.155218,6000000,APT BLDG,CONDO/APT
1883788,454292,1429496,7147479,42.348075,-71.15526,6000000,4-8 UNIT APT,CONDO/APT
1883788,454292,1429496,7147479,42.347934,-71.155351,6000000,4-8 UNIT APT,CONDO/APT
271772,65540,206232,1031158,42.309121,-71.071105,876000,2-FAM RES,CONVENTIONAL
155712,37551,118161,590802,42.304101,-71.118932,460000,CONDOMINIUM,DECKER
735492,177370,558122,2790609,42.35205,-71.069294,1850000,CONDOMINIUM,MID-RISE
1605229,456379,1148850,5744251,42.35205,-71.069294,3690000,CONDOMINIUM,MID-RISE
188189,45383,142806,714031,42.313548,-71.08444,575000,2-FAM RES,CONVENTIONAL
103343,42589,60754,596814,42.297515,-71.064189,501000,1-FAM RES,COLONIAL
168332,40594,127738,638689,42.338272,-71.047724,450000,RES UDV LAND,ROW-MIDDLE
1767349,426212,1341137,6705685,42.352207,-71.068581,5400000,CONDOMINIUM,HIGH-RISE
311516,59958,251558,1006230,42.379882,-71.031716,895000,3-FAM RES,SEMI DETACHD
1228240,296201,932039,4660191,42.351967,-71.082347,3515000,CONDOMINIUM,ROW-MIDDLE
1679711,405077,1274634,6373169,42.351967,-71.082347,5350000,CONDOMINIUM,ROW-MIDDLE
318042,61214,256828,1027314,42.24918,-71.131185,562500,4-8 UNIT APT,CONDO/APT
978020,73995,904025,1835370,42.350219,-71.083096,1478000,CONDOMINIUM,ROW-MIDDLE
919676,221788,697888,3489439,42.351772,-71.082362,2810000,CONDOMINIUM,ROW-MIDDLE
1808493,387168,1421325,6294440,42.349561,-71.082977,4650000,INN/RESORT,CONDO/APT
1521977,367038,1154939,5774693,42.349561,-71.082977,4085000,INN/RESORT,CONDO/APT
359880,86788,273092,1365460,42.375754,-71.033861,1160000,1-FAM RES,RAISED RANCH
629644,151844,477800,2388997,42.350793,-71.083413,1970000,CONDOMINIUM,ROW-MIDDLE
487432,164799,322633,2396891,42.350793,-71.083413,1835000,CONDOMINIUM,ROW-MIDDLE
192141,46336,145805,729025,42.335421,-71.048539,575000,CONDOMINIUM,ROW-END
312439,75347,237092,1185459,42.375757,-71.033696,935000,3-FAM RES,SEMI DETACHD
2673365,112900,2560465,3981496,42.351936,-71.082463,3100000,CONDOMINIUM,ROW-MIDDLE
582485,91095,491390,1637964,42.364667,-71.031708,1375000,3-FAM RES,CONVENTIONAL
134178,32358,101820,509097,42.244636,-71.116725,337500,1-FAM RES,CAPE COD
430151,64759,365392,1180494,42.286199,-71.141914,1050000,3-FAM RES,DECKER
208749,40178,168571,674285,42.376726,-71.039744,525000,3-FAM RES,DECKER
2222363,535943,1686420,8432100,42.350696,-71.083414,7500000,CONDOMINIUM,ROW-MIDDLE
621292,119582,501710,2006839,42.350696,-71.083414,1785000,CONDOMINIUM,ROW-MIDDLE
426377,82066,344311,1377243,42.350696,-71.083414,1225000,CONDOMINIUM,ROW-MIDDLE
474104,114334,359770,1798847,42.338198,-71.047796,1600000,CONDOMINIUM,TOWNHOUSE
185104,77174,107930,1079293,42.380391,-71.030621,890000,3-FAM RES,SEMI DETACHD
435484,83819,351665,1406659,42.330127,-71.055759,1195000,3-FAM RES,CONVENTIONAL
375353,72245,303108,1212434,42.330583,-71.05474,1030000,2-FAM RES,CONVENTIONAL
380250,77078,303172,1273323,42.380391,-71.030621,1050000,3-FAM RES,SEMI DETACHD
149090,35954,113136,565680,42.281437,-71.149327,440000,2-FAM RES,CONVENTIONAL
1014589,244677,769912,3849560,42.344877,-71.081227,3100000,CONDOMINIUM,ROW-END
1014589,244677,769912,3849560,42.344877,-71.081227,3100000,CONDOMINIUM,ROW-END
1014589,244677,769912,3849560,42.344877,-71.081227,3100000,CONDOMINIUM,ROW-END
219775,53000,166775,833872,42.262243,-71.163657,700000,2-FAM RES,TWO FAMILY
206190,49724,156466,782329,42.376783,-71.039749,630000,2-FAM RES,CONVENTIONAL
614600,231417,383183,3295939,42.332683,-71.051866,2800000,MXU RES+COM,CONDO/APT
369207,45921,323286,901283,42.334276,-71.035579,690000,2-FAM RES,SEMI DETACHD
604707,54934,549773,1241205,42.363895,-71.051904,1104000,CONDOMINIUM,LOW-RISE
330041,79592,250449,1252244,42.336582,-71.048555,975000,3-FAM RES,DECKER
118626,28607,90019,450094,42.293837,-71.157304,355000,1-FAM RES,BNGL/COTTAGE
219273,52879,166394,831967,42.314486,-71.092506,740000,3-FAM RES,CONVENTIONAL
200012,48234,151778,758889,42.287224,-71.159845,675000,1-FAM RES,COLONIAL
1232446,297215,935231,4676156,42.352056,-71.135225,3100000,9 + UNIT APT,CONDO/APT
297944,57346,240598,962390,42.372579,-71.039976,775000,4-8 UNIT APT,CONDO/APT
14270,3441,10829,54145,42.300921,-71.114879,40000,1-FAM RES,COLONIAL
177648,42841,134807,674033,42.316211,-71.109878,482500,2-FAM RES,TWO FAMILY
68717,16571,52146,260728,42.271661,-71.100886,215000,1-FAM RES,CAPE COD
511265,123296,387969,1939843,42.346026,-71.072933,1530000,1-FAM RES,ROW-MIDDLE
128411,30967,97444,487219,42.282673,-71.122507,409000,1-FAM RES,BNGL/COTTAGE
239392,57731,181661,908304,42.292414,-71.162908,749000,2-FAM RES,CONVENTIONAL
86730,20915,65815,329075,42.269629,-71.129493,265000,1-FAM RES,CAPE COD
834198,201174,633024,3165118,42.344133,-71.069905,2610000,CONDOMINIUM,ROW-MIDDLE
265657,64065,201592,1007957,42.373461,-71.065568,795000,CONDOMINIUM,ROW-END
206558,49813,156745,783724,42.380514,-71.036455,600000,3-FAM RES,SEMI DETACHD
208388,50254,158134,790667,42.376433,-71.039203,615000,3-FAM RES,SEMI DETACHD
280382,67616,212766,1063830,42.331312,-71.111672,725000,3-FAM RES,ROW-MIDDLE
86065,20755,65310,326549,42.308557,-71.085986,231000,2-FAM RES,TWO FAMILY
183449,44240,139209,696045,42.33373,-71.103193,525000,CONDOMINIUM,ROW-MIDDLE
178208,42976,135232,676158,42.33373,-71.103193,510000,CONDOMINIUM,ROW-MIDDLE
214059,51622,162437,812185,42.360483,-71.063522,600000,CONDOMINIUM,ROW-MIDDLE
213914,51587,162327,811633,42.296352,-71.076199,581000,CHARITY PROP,CONDO/APT
207421,50021,157400,786996,42.294278,-71.051256,700000,1-FAM RES,CONVENTIONAL
39278,9472,29806,149027,42.330369,-71.054053,105000,CONDOMINIUM,ROW-END
297545,71755,225790,1128946,42.323572,-71.057839,879000,2-FAM RES,CONVENTIONAL
576665,110992,465673,1862690,42.296352,-71.076199,1500000,CHARITY PROP,CONDO/APT
142314,34320,107994,539967,42.343827,-71.167705,420000,CONDOMINIUM,LOW-RISE
504999,121785,383214,1916069,42.363702,-71.051915,1350000,MXU RES+COM,RAISED CAPE
502600,121206,381394,1906966,42.363702,-71.051915,1225000,CONDOMINIUM,RAISED CAPE
142017,34248,107769,538845,42.26132,-71.163209,425000,1-FAM RES,RANCH
116340,28056,88284,441420,42.34629,-71.138977,375000,CONDOMINIUM,MID-RISE
337501,81391,256110,1280549,42.350598,-71.08413,1010000,CONDOMINIUM,ROW-MIDDLE
284343,68571,215772,1078857,42.350598,-71.08413,840000,CONDOMINIUM,ROW-MIDDLE
1066941,186529,880412,3228174,42.349455,-71.08341,2200000,4-8 UNIT APT,CONDO/APT
143688,34651,109037,545184,42.340429,-71.051468,430000,CONDOMINIUM,LOW-RISE
2305869,556081,1749788,8748938,42.350512,-71.084447,5800000,9 + UNIT APT,ROW-MIDDLE
137805,48983,88822,705352,42.379684,-71.029913,540000,3-FAM RES,VICTORIAN
306013,73797,232216,1161077,42.367963,-71.037896,935000,3-FAM RES,ROW-END
9204,2219,6985,34923,42.364644,-71.031288,25000,4-8 UNIT APT,CONDO/APT
51200,30798,20402,408051,42.279328,-71.140344,287500,CONDOMINIUM,FREE-STANDNG
740787,178647,562140,2810700,42.353385,-71.080082,2500000,CONDOMINIUM,ROW-MIDDLE
444471,107188,337283,1686419,42.31849,-71.056726,1500000,3-FAM RES,DECKER
225105,54286,170819,854095,42.280549,-71.078364,665000,4-8 UNIT APT,CONDO/APT
130516,87218,43298,1141084,42.335393,-71.048117,900000,3-FAM RES,DECKER
685634,165347,520287,2601437,42.361945,-71.142973,2210000,1-FAM RES,CONVENTIONAL
102038,24607,77431,387155,42.34629,-71.138977,325000,CONDOMINIUM,MID-RISE
287654,69370,218284,1091420,42.318393,-71.057158,900000,CHARITY PROP,COLONIAL
379320,122449,256871,1798095,42.335737,-71.049505,1400000,3-FAM RES,DECKER
40983,9883,31100,155499,42.323674,-71.095881,110000,1-FAM RES,COLONIAL
56534,44421,12113,571225,42.364734,-71.031303,460000,CONDOMINIUM,DUPLEX
1427064,344149,1082915,5414572,42.348934,-71.074349,4000000,CONDOMINIUM,HIGH-RISE
433465,68197,365268,1223646,42.357947,-71.050993,670000,CONDOMINIUM,HIGH-RISE
1190569,287116,903453,4517266,42.366823,-71.053505,3725000,4-8 UNIT APT,CONDO/APT
795484,191838,603646,3018230,42.366823,-71.053505,2350000,4-8 UNIT APT,CONDO/APT
622303,53773,568530,1245351,42.358168,-71.067324,920000,CONDOMINIUM,MID-RISE
490930,118392,372538,1862690,42.343696,-71.074049,1500000,CONDOMINIUM,ROW-END
79677,19214,60463,302313,42.284153,-71.09287,213000,3-FAM RES,DECKER
442762,106776,335986,1679929,42.329332,-71.088828,1325000,2-FAM RES,CONDO/APT
784885,189282,595603,2978014,42.335855,-71.027072,2200000,3-FAM RES,CONVENTIONAL
319241,68214,251027,1109610,42.283655,-71.066314,915000,3-FAM RES,DECKER
199759,48173,151586,757930,42.319799,-71.07626,625000,3-FAM RES,ROW-END
70366,16969,53397,266985,42.290173,-71.090029,215000,CONDOMINIUM,DECKER
171154,41275,129879,649394,42.302112,-71.06993,535500,3-FAM RES,DECKER
9588,2312,7276,36380,42.302112,-71.06993,30000,3-FAM RES,DECKER
223731,53954,169777,848882,42.302112,-71.06993,700000,3-FAM RES,DECKER
186466,41291,145175,664889,42.272022,-71.064613,501500,3-FAM RES,DECKER
88811,26965,61846,401244,42.287014,-71.087671,266000,3-FAM RES,DECKER
1051918,253679,798239,3991194,42.348748,-71.069732,3550000,CONDOMINIUM,MID-RISE
95727,23085,72642,363209,42.289612,-71.07021,260000,3-FAM RES,DECKER
178283,118185,60098,1547646,42.364408,-71.056516,1205000,4-8 UNIT APT,CONDO/APT
89419,21564,67855,339272,42.304625,-71.081057,240000,3-FAM RES,CONVENTIONAL
350974,57077,293897,1012311,42.344904,-71.152631,775000,2-FAM RES,CONVENTIONAL
143187,34530,108657,543281,42.276327,-71.118549,423000,1-FAM RES,CAPE COD
169522,40881,128641,643203,42.342855,-71.087225,455000,CONDOMINIUM,ROW-MIDDLE
502978,121297,381681,1908405,42.366389,-71.055546,1350000,4-8 UNIT APT,CONDO/APT
601978,145172,456806,2284029,42.366389,-71.055546,1635000,4-8 UNIT APT,CONDO/APT
325946,78604,247342,1236708,42.347025,-71.150625,1100000,2-FAM RES,CONVENTIONAL
510190,98198,411992,1647969,42.36541,-71.057698,1400000,MXU RES+COM,RAISED CAPE
138560,59735,78825,830692,42.353095,-71.163514,685000,2-FAM RES,TWO FAMILY
304441,73418,231023,1155111,42.334181,-71.102852,826875,3-FAM RES,ROW-MIDDLE
244599,58987,185612,928060,42.346543,-71.160955,700000,2-FAM RES,TWO FAMILY
843753,203478,640275,3201374,42.344004,-71.078255,2525000,CONDOMINIUM,ROW-MIDDLE
748196,180434,567762,2838807,42.34481,-71.070261,2525000,CONDOMINIUM,MID-RISE
185196,44661,140535,702674,42.343696,-71.074049,530000,CONDOMINIUM,ROW-END
86820,44754,42066,605374,42.338446,-71.049005,487500,1-FAM RES,ROW-MIDDLE
100596,24259,76337,381681,42.307025,-71.066306,270000,3-FAM RES,SEMI DETACHD
43717,10542,33175,165874,42.270914,-71.109138,129150,1-FAM RES,RANCH
36419,8782,27637,138184,42.312508,-71.080096,116000,CONDOMINIUM,TOWNHOUSE
68239,16456,51783,258913,42.342205,-71.085568,208500,CONDOMINIUM,MID-RISE
1658961,400073,1258888,6294440,42.349371,-71.083748,4650000,MXU RES+COM,CONDO/APT
219232,34285,184947,616489,42.350105,-71.077253,480000,CONDOMINIUM,MID-RISE
221014,53299,167715,838574,42.350105,-71.077253,691500,CONDOMINIUM,MID-RISE
71353,17207,54146,270728,42.304135,-71.083931,200000,2-FAM RES,CONVENTIONAL
225558,54395,171163,855813,42.335293,-71.049188,675000,1-FAM RES,ROW-MIDDLE
86158,20777,65381,326902,42.307111,-71.066212,231250,3-FAM RES,SEMI DETACHD
460029,110940,349089,1745444,42.376489,-71.039153,1552500,MXU RES+COM,RAISED CAPE
1078704,260139,818565,4092825,42.343062,-71.068835,3375000,MXU RES+COM,RAISED CAPE
46431,19358,27073,270728,42.368043,-71.037599,200000,3-FAM RES,ROW-MIDDLE
138322,26623,111699,446795,42.368043,-71.037599,337000,3-FAM RES,ROW-MIDDLE
141835,23391,118444,412861,42.335451,-71.049064,305000,2-FAM RES,ROW-MIDDLE
233795,56381,177414,887069,42.313617,-71.107001,635000,2-FAM RES,TWO FAMILY
965497,232838,732659,3663291,42.353333,-71.07993,2950000,CONDOMINIUM,ROW-MIDDLE
405503,45383,360120,931345,42.286268,-71.139028,750000,3-FAM RES,CONVENTIONAL
760214,183332,576882,2884407,42.367657,-71.03345,2275000,9 + UNIT APT,CONDO/APT
403952,69260,334692,1206448,42.289484,-71.048107,775000,4-8 UNIT APT,CONDO/APT
360892,87032,273860,1369300,42.328082,-71.100009,1080000,2-FAM RES,CONVENTIONAL
651479,125392,526087,2104345,42.328118,-71.099807,1506375,3-FAM RES,DECKER
347714,66925,280789,1123155,42.380238,-71.028712,999000,3-FAM RES,DECKER
243539,58731,184808,924040,42.305868,-71.085748,785000,1-FAM RES,CONVENTIONAL
1465107,229129,1235978,4119924,42.322787,-71.090613,3500000,4-8 UNIT APT,CONDO/APT
216519,52215,164304,821522,42.310635,-71.091633,639000,3-FAM RES,DECKER
1761675,306508,1455167,5313049,42.351782,-71.083041,3925000,9 + UNIT APT,CONDO/APT
93089,22449,70640,353197,42.284837,-71.049459,275000,1-FAM RES,COLONIAL
138926,33503,105423,527111,42.285162,-71.048676,410000,1-FAM RES,CONVENTIONAL
408154,98430,309724,1548620,42.36462,-71.030865,1300000,3-FAM RES,CONDO/APT
503536,143467,360069,2165828,42.328232,-71.099861,1600000,3-FAM RES,CONVENTIONAL
373932,90211,283721,1419169,42.328232,-71.099861,999900,3-FAM RES,CONVENTIONAL
256307,44388,211919,770612,42.377361,-71.039798,600000,AUTO REPAIR,CONDO/APT
67332,16237,51095,255475,42.376266,-71.032942,180000,3-FAM RES,DECKER
102398,21254,81144,348664,42.283745,-71.082278,275000,2-FAM RES,CONVENTIONAL
979105,37408,941697,1412545,42.335111,-71.048725,1200000,CONDOMINIUM,FREE-STANDNG
419199,101093,318106,1590530,42.339354,-71.050024,1175000,4-8 UNIT APT,CONDO/APT
502530,97959,404571,1637550,42.313339,-71.107546,1275000,1-FAM RES,BNGL/COTTAGE
899702,216971,682731,3413651,42.344222,-71.101666,2900000,CONDOMINIUM,HIGH-RISE
701045,169063,531982,2659908,42.332951,-71.071259,1965000,2-FAM RES,ROW-MIDDLE
7926933,147794,7779139,9639367,42.357555,-71.067477,5700000,1-FAM RES,ROW-MIDDLE
1054733,254358,800375,4001873,42.341348,-71.079032,3300000,CONDOMINIUM,ROW-MIDDLE
1054733,254358,800375,4001873,42.341348,-71.079032,3300000,CONDOMINIUM,ROW-MIDDLE
1054733,254358,800375,4001873,42.341348,-71.079032,3300000,CONDOMINIUM,ROW-MIDDLE
1054733,254358,800375,4001873,42.341348,-71.079032,3300000,CONDOMINIUM,ROW-MIDDLE
1054733,254358,800375,4001873,42.341348,-71.079032,3300000,CONDOMINIUM,ROW-MIDDLE
1054733,254358,800375,4001873,42.341348,-71.079032,3300000,CONDOMINIUM,ROW-MIDDLE
1054733,254358,800375,4001873,42.341348,-71.079032,3300000,CONDOMINIUM,ROW-MIDDLE
382925,92345,290580,1452898,42.341348,-71.079032,1170000,CONDOMINIUM,ROW-MIDDLE
609871,102551,507320,1798095,42.364386,-71.056563,1400000,3-FAM RES,SEMI DETACHD
28672,6914,21758,108790,42.322303,-71.080957,76650,3-FAM RES,SEMI DETACHD
100747,24296,76451,382255,42.342777,-71.094816,340000,CONDOMINIUM,LOW-RISE
139608,33667,105941,529704,42.343631,-71.074276,450000,CONDOMINIUM,ROW-MIDDLE
1641142,395776,1245366,6226830,42.354908,-71.074857,4000000,CONDOMINIUM,ROW-END
2007673,18257,1989416,2219220,42.3272,-71.100636,1830000,3-FAM RES,DECKER
712660,57808,654852,1382465,42.31782,-71.056732,1140000,1-FAM RES,COLONIAL
410082,55254,354828,1050290,42.343407,-71.070022,740000,CONDOMINIUM,ROW-MIDDLE
368182,88790,279392,1396959,42.358036,-71.051007,1000000,CONDOMINIUM,HIGH-RISE
368182,88790,279392,1396959,42.357947,-71.050993,1000000,CONDOMINIUM,HIGH-RISE
238751,122531,116220,1658472,42.329708,-71.100399,1290000,3-FAM RES,CONVENTIONAL
201395,48568,152827,764131,42.324893,-71.0575,585000,3-FAM RES,DECKER
177714,42857,134857,674285,42.336854,-71.039841,525000,CONDOMINIUM,TOWNHOUSE
711156,171501,539655,2698272,42.360834,-71.066374,2400000,1-FAM RES,ROW-MIDDLE
143864,34694,109170,545850,42.330817,-71.053516,425000,1-FAM RES,CONVENTIONAL
307480,82624,224856,1264815,42.352926,-71.168899,1125000,2-FAM RES,CONVENTIONAL
50304,12131,38173,190863,42.339795,-71.15247,141000,CONDOMINIUM,LOW-RISE
456980,110204,346776,1733877,42.349153,-71.068254,1350000,1-FAM RES,ROW-MIDDLE
93803,42860,50943,590406,42.380457,-71.036606,452000,3-FAM RES,SEMI DETACHD
232861,56156,176705,883521,42.322166,-71.058001,625000,2-FAM RES,TWO FAMILY
176735,42621,134114,670568,42.290934,-71.045534,540000,1-FAM RES,CONDO/APT
167079,40292,126787,633935,42.291003,-71.045612,500000,1-FAM RES,CONDO/APT
1192497,227258,965239,3825643,42.360257,-71.067722,3250000,4-8 UNIT APT,CONDO/APT
269380,64963,204417,1022082,42.319261,-71.059023,795000,3-FAM RES,DECKER
221823,53494,168329,841641,42.294527,-71.146184,715000,1-FAM RES,CAPE COD
198223,47803,150420,752098,42.376514,-71.038977,585000,3-FAM RES,SEMI DETACHD
61878,14922,46956,234776,42.30194,-71.066762,160000,3-FAM RES,DECKER
383459,92474,290985,1454921,42.332086,-71.107398,1236000,2-FAM RES,CONVENTIONAL
232681,56113,176568,882840,42.332928,-71.049808,750000,CONDOMINIUM,ROW-END
124097,29927,94170,470848,42.332928,-71.049808,400000,CONDOMINIUM,ROW-END
674211,162592,511619,2558094,42.358253,-71.069789,2060000,CONDOMINIUM,ROW-MIDDLE
196332,47347,148985,744925,42.309332,-71.062483,580000,3-FAM RES,DECKER
44552,10744,33808,169039,42.339795,-71.15247,127500,CONDOMINIUM,LOW-RISE
306085,59243,246842,992512,42.328539,-71.091326,772000,2-FAM RES,CONVENTIONAL
86668,20900,65768,328839,42.343264,-71.144747,218000,CONDOMINIUM,LOW-RISE
215618,51998,163620,818099,42.350158,-71.083678,695000,CONDOMINIUM,ROW-MIDDLE
320416,77271,243145,1215725,42.341304,-71.158926,860000,2-FAM RES,CONVENTIONAL
104741,25259,79482,397407,42.34988,-71.084357,280000,CONDOMINIUM,ROW-MIDDLE
214828,51807,163021,815102,42.350158,-71.083678,725000,CONDOMINIUM,ROW-MIDDLE
225010,54263,170747,853733,42.321373,-71.092559,704000,1-FAM RES,COLONIAL
164362,39637,124725,623624,42.361009,-71.06812,425000,CONDOMINIUM,ROW-MIDDLE
132960,32064,100896,504478,42.293855,-71.061625,416000,1-FAM RES,COLONIAL
183280,44199,139081,695404,42.309115,-71.074196,560000,3-FAM RES,SEMI DETACHD
30325,7313,23012,115059,42.367737,-71.03316,85000,3-FAM RES,DECKER
266870,64358,202512,1012559,42.349253,-71.084215,850000,CONDOMINIUM,MID-RISE
1495798,360725,1135073,5675365,42.350341,-71.084721,5048000,CONDOMINIUM,ROW-MIDDLE
2571337,352562,2218775,6656324,42.351508,-71.083358,5250000,9 + UNIT APT,CONDO/APT
201798,58115,143683,875159,42.367886,-71.037238,670000,3-FAM RES,SEMI DETACHD
327428,78962,248466,1242329,42.367886,-71.037238,1105000,3-FAM RES,SEMI DETACHD
407510,98274,309236,1546178,42.353145,-71.080573,1275000,CONDOMINIUM,MID-RISE
407510,98274,309236,1546178,42.353145,-71.080573,1275000,CONDOMINIUM,MID-RISE
322159,77691,244468,1222339,42.346859,-71.074162,875000,CONDOMINIUM,MID-RISE
391529,94420,297109,1485544,42.353091,-71.081484,1225000,CONDOMINIUM,MID-RISE
651893,157209,494684,2473416,42.349819,-71.084583,2200000,CONDOMINIUM,ROW-MIDDLE
126388,30479,95909,479542,42.314485,-71.104655,373000,CONDOMINIUM,DECKER
218392,52667,165725,828625,42.338128,-71.048504,625000,3-FAM RES,DECKER
344997,65371,279626,1102434,42.340767,-71.159215,857500,2-FAM RES,CONVENTIONAL
1021241,108746,912495,2281237,42.344506,-71.139055,1915000,3-FAM RES,DECKER
396785,95688,301097,1505482,42.344506,-71.139055,1171000,3-FAM RES,DECKER
336149,81065,255084,1275420,42.30655,-71.127101,962000,1-FAM RES,SPLIT LEVEL
119793,54483,65310,751069,42.367639,-71.03715,575000,3-FAM RES,DECKER
349494,67098,282396,1126931,42.335169,-71.048998,850000,2-FAM RES,CONVENTIONAL
1502196,362268,1139928,5699638,42.308494,-71.05884,4700000,3-FAM RES,CONVENTIONAL
1502196,362268,1139928,5699638,42.308262,-71.058658,4700000,MXU RES+COM,CONDO/APT
134187,32360,101827,509135,42.388101,-71.005448,410000,1-FAM RES,CAPE COD
407898,98368,309530,1547646,42.313901,-71.103049,1205000,3-FAM RES,CONDO/APT
63944,52701,11243,674568,42.324967,-71.072222,600000,3-FAM RES,SEMI DETACHD
211712,51056,160656,803280,42.343402,-71.081901,475000,CONDOMINIUM,ROW-MIDDLE
78282,20428,57854,314981,42.307253,-71.117238,245000,CONDOMINIUM,FREE-STANDNG
806628,194525,612103,3060515,42.329129,-71.058124,2600000,3-FAM RES,CONVENTIONAL
106674,25725,80949,404744,42.297507,-71.059507,260000,CONDOMINIUM,FREE-STANDNG
293866,40292,253574,760722,42.313018,-71.066763,600000,3-FAM RES,DECKER
145515,35092,110423,552111,42.285986,-71.051473,389000,1-FAM RES,COLONIAL
2090153,402299,1687854,6751414,42.350445,-71.086614,5325000,1-FAM RES,ROW-MIDDLE
672775,129491,543284,2173138,42.309574,-71.061178,1750000,OTHER EXEMPT,CONVENTIONAL
120553,29072,91481,457401,42.390067,-70.999864,345000,2-FAM RES,TWO FAMILY
68181,16442,51739,258694,42.390421,-71.011549,183000,3-FAM RES,CONVENTIONAL
250858,60496,190362,951806,42.354229,-71.073315,799000,CONDOMINIUM,ROW-MIDDLE
154563,43943,110619,553098,42.300187,-71.084598,408600,3-FAM RES,CONVENTIONAL
91689,22111,69578,347886,42.280358,-71.150329,257000,2-FAM RES,CONVENTIONAL
418955,53868,365087,1043106,42.285647,-71.133778,840000,3-FAM RES,CONVENTIONAL
228773,55170,173603,868013,42.306934,-71.064088,699000,1-FAM RES,COLONIAL
42975,34877,8098,447082,42.303368,-71.107166,315000,CONDOMINIUM,DECKER
222914,53757,169157,845785,42.384922,-71.004133,710000,2-FAM RES,CONVENTIONAL
155120,37408,117712,588560,42.312806,-71.113505,500000,1-FAM RES,COLONIAL
263705,63594,200111,1000552,42.294281,-71.051245,850000,2-FAM RES,CONVENTIONAL
1129140,272302,856838,4284187,42.358756,-71.069779,3450000,1-FAM RES,ROW-MIDDLE
397619,76531,321088,1284353,42.315946,-71.055019,1000000,3-FAM RES,CONVENTIONAL
1367790,96193,1271597,2482345,42.357961,-71.072078,1999000,CONDOMINIUM,ROW-MIDDLE
24546,5919,18627,93134,42.339305,-71.049301,75000,CONDOMINIUM,FREE-STANDNG
55886,13477,42409,212045,42.323658,-71.096342,150000,3-FAM RES,SEMI DETACHD
745782,143543,602239,2408955,42.377077,-71.039291,1900000,9 + UNIT APT,CONDO/APT
745782,143543,602239,2408955,42.377111,-71.039292,1900000,9 + UNIT APT,CONDO/APT
263705,63594,200111,1000552,42.330247,-71.055128,850000,2-FAM RES,CONVENTIONAL
532573,51889,480684,1133788,42.322568,-71.103107,868000,3-FAM RES,CONVENTIONAL
215344,25944,189400,515952,42.330127,-71.054885,395000,1-FAM RES,ROW-END
920263,201538,718725,3255400,42.349146,-71.084602,1925000,MXU COM+RES,CONDO/APT
215877,52060,163817,819081,42.342622,-71.069779,543000,CONDOMINIUM,ROW-MIDDLE
185196,44661,140535,702675,42.367125,-71.035728,625000,MXU RES+COM,RAISED CAPE
89046,21474,67572,337858,42.290875,-71.074556,239000,3-FAM RES,DECKER
425473,102606,322867,1614331,42.339327,-71.048191,1300000,3-FAM RES,SEMI DETACHD
185239,44672,140567,702835,42.35025,-71.085384,590000,CONDOMINIUM,ROW-MIDDLE
1737147,342489,1394658,5705420,42.364335,-71.051657,4500000,9 + UNIT APT,CONDO/APT
27954,6741,21213,106064,42.376489,-71.039153,80000,CONDOMINIUM,ROW-MIDDLE
153748,37077,116671,583352,42.34991,-71.086243,440000,CONDOMINIUM,ROW-MIDDLE
421181,101571,319610,1598047,42.352999,-71.081112,1243000,CONDOMINIUM,MID-RISE
236734,57090,179644,898220,42.35025,-71.085384,577000,CONDOMINIUM,ROW-MIDDLE
67249,16217,51032,255160,42.375845,-71.034668,180500,3-FAM RES,DECKER
163388,31447,131941,527762,42.271072,-71.08521,425000,2-FAM RES,DUPLEX
825155,266371,558784,3911487,42.351391,-71.083809,2800000,9 + UNIT APT,CONDO/APT
123000,29662,93338,466686,42.380273,-71.028888,363000,1-FAM RES,ROW-END
301160,85622,215538,1077690,42.307677,-71.065608,850000,MXU RES+COM,CONDO/APT
1336639,322342,1014297,5071485,42.350179,-71.085632,4000000,CONDOMINIUM,ROW-MIDDLE
975880,235000,740880,3698724,42.351588,-71.083782,2606000,1-FAM RES,ROW-MIDDLE
2151650,518890,1632760,8163800,42.351751,-71.083156,6350000,1-FAM RES,ROW-END
203305,49028,154277,771382,42.367292,-71.032643,600000,3-FAM RES,DECKER
1290553,311228,979325,4896623,42.350179,-71.085632,3450000,CONDOMINIUM,ROW-MIDDLE
2237716,539645,1698071,8490352,42.352948,-71.082034,6500000,9 + UNIT APT,CONDO/APT
347847,83886,263961,1319802,42.342483,-71.069819,975000,CONDOMINIUM,ROW-END
90851,21909,68942,344708,42.286115,-71.167141,260000,1-FAM RES,COLONIAL
125688,30310,95378,476889,42.293929,-71.060612,325000,3-FAM RES,DECKER
263818,63622,200196,1000979,42.351567,-71.083864,755000,CONDOMINIUM,ROW-MIDDLE
165660,39950,125710,628548,42.351567,-71.083864,442855,CONDOMINIUM,ROW-MIDDLE
163644,39464,124180,620896,42.283722,-71.08285,500000,3-FAM RES,CONVENTIONAL
78548,18942,59606,298030,42.283722,-71.08285,240000,3-FAM RES,CONVENTIONAL
123215,29714,93501,467504,42.339181,-71.047958,364000,1-FAM RES,SEMI DETACHD
1497038,361024,1136014,5680068,42.349051,-71.084935,3765531,MXU COM+RES,CONDO/APT
342817,82673,260144,1300718,42.317644,-71.09662,1105000,4-8 UNIT APT,CONDO/APT
27108,6537,20571,102851,42.314057,-71.054771,80000,CONDOMINIUM,FREE-STANDNG
162973,39302,123671,618354,42.294867,-71.075749,550000,3-FAM RES,DECKER
142229,70584,71645,960062,42.376894,-71.03222,735000,MXU RES+COM,CONDO/APT
4309038,646070,3662968,11794766,42.349367,-71.149092,9029776,9 + UNIT APT,CONDO/APT
80104,19317,60787,303931,42.325072,-71.107906,215000,<BLANK>,TWO FAMILY
710622,136775,573847,2295386,42.337173,-71.03845,1950000,2-FAM RES,CONVENTIONAL
80228,19347,60881,304401,42.311202,-71.059199,180000,3-FAM RES,SEMI DETACHD
190023,45825,144198,720986,42.380062,-71.028368,612500,2-FAM RES,TWO FAMILY
1257542,303267,954275,4771373,42.357637,-71.068373,3715000,1-FAM RES,ROW-MIDDLE
289872,69905,219967,1099835,42.329784,-71.097568,812500,3-FAM RES,DECKER
135745,26127,109618,438469,42.375772,-71.035979,390000,1-FAM RES,ROW-MIDDLE
69952,16869,53083,265411,42.285248,-71.070993,187000,2-FAM RES,CONVENTIONAL
235473,56786,178687,893434,42.35337,-71.062604,750000,CONDOMINIUM,MID-RISE
201657,48631,153026,765128,42.353283,-71.063135,650000,CONDOMINIUM,MID-RISE
201751,48654,153097,765485,42.35337,-71.062604,565500,CONDOMINIUM,MID-RISE
447462,107909,339553,1697764,42.34364,-71.068978,1400000,1-FAM RES,ROW-MIDDLE
390886,94265,296621,1483102,42.318981,-71.054341,1245000,3-FAM RES,DECKER
898166,52859,845307,1510624,42.342059,-71.081173,1175000,CONDOMINIUM,ROW-END
59612,14375,45237,226181,42.309193,-71.065043,160000,3-FAM RES,DECKER
1313352,316726,996626,4983126,42.353258,-71.074211,3396000,CONDOMINIUM,ROW-MIDDLE
88230,21277,66953,334764,42.354684,-71.150013,252500,CONDOMINIUM,LOW-RISE
83488,20133,63355,316771,42.254362,-71.125393,210000,4-8 UNIT APT,CONDO/APT
485737,39401,446336,942264,42.366538,-71.059491,570000,CONDOMINIUM,HIGH-RISE
341977,50366,291611,925546,42.325575,-71.077906,730000,3-FAM RES,ROW-MIDDLE
121454,29289,92165,460821,42.314692,-71.081956,380000,2-FAM RES,TWO FAMILY
179925,43390,136535,682673,42.35337,-71.062604,531000,CONDOMINIUM,MID-RISE
157508,37984,119524,597619,42.353687,-71.138183,371276,CONDOMINIUM,MID-RISE
161750,39007,122743,613715,42.353765,-71.138066,381276,CONDOMINIUM,MID-RISE
340762,82177,258585,1292922,42.337753,-71.033401,1150000,CONDOMINIUM,LOW-RISE
60225,14523,45702,228509,42.312872,-71.072682,161000,2-FAM RES,CONVENTIONAL
880110,212246,667864,3339319,42.367496,-71.057044,2600000,4-8 UNIT APT,CONDO/APT
111687,26934,84753,423763,42.282433,-71.094428,360000,2-FAM RES,TWO FAMILY
278295,67113,211182,1055906,42.296094,-71.061137,700000,4-8 UNIT APT,CONDO/APT
165166,38378,126788,609846,42.314923,-71.058274,481000,CONDOMINIUM,DECKER
113027,27257,85770,428848,42.336973,-71.046867,360000,1-FAM RES,CONVENTIONAL
155711,37551,118160,590802,42.331465,-71.040737,460000,CONDOMINIUM,ROW-MIDDLE
266974,35904,231070,682986,42.322192,-71.077127,550000,2-FAM RES,SEMI DETACHD
296826,71582,225244,1126218,42.363853,-71.057592,876000,3-FAM RES,CONDO/APT
452481,87090,365391,1461564,42.282941,-71.072239,1300000,3-FAM RES,DECKER
627178,32732,594446,1006438,42.282941,-71.072239,855000,3-FAM RES,DECKER
679934,111610,568324,1973111,42.282582,-71.088667,1755000,4-8 UNIT APT,CONDO/APT
281045,67776,213269,1066344,42.337311,-71.048348,685000,MXU COM+RES,CONDO/APT
251612,107929,143683,1502139,42.333944,-71.102995,1150000,CONDOMINIUM,ROW-MIDDLE
251612,107929,143683,1502139,42.333944,-71.102995,1150000,CONDOMINIUM,ROW-MIDDLE
829480,200036,629444,3147220,42.337677,-71.075756,2325000,MXU RES+COM,RAISED CAPE
49234,11873,37361,186804,42.317207,-71.0543,120000,1-FAM RES,CONVENTIONAL
86882,20952,65930,329646,42.268769,-71.119723,260000,1-FAM RES,RANCH
356778,86040,270738,1353689,42.324426,-71.058068,1150000,3-FAM RES,DECKER
1898640,200978,1697662,4227292,42.288664,-71.063288,3760000,9 + UNIT APT,CONDO/APT
507755,122449,385306,1926530,42.288664,-71.063288,1500000,9 + UNIT APT,CONDO/APT
757910,182776,575134,2875667,42.363442,-71.053474,2239000,4-8 UNIT APT,CONDO/APT
459288,110761,348527,1742633,42.322192,-71.077127,1550000,2-FAM RES,SEMI DETACHD
459288,110761,348527,1742633,42.322183,-71.077104,1550000,2-FAM RES,SEMI DETACHD
133378,37920,95457,477288,42.380555,-71.063559,360000,1-FAM RES,COLONIAL
133664,32234,101430,507148,42.312634,-71.125152,400000,1-FAM RES,CONTEMPORARY
183613,96687,86926,1303883,42.312634,-71.125152,1050000,1-FAM RES,CONTEMPORARY
323496,43288,280208,825055,42.294192,-71.0811,530000,4-8 UNIT APT,CONDO/APT
2134961,514865,1620096,8100476,42.357413,-71.067683,6800000,3-FAM RES,ROW-MIDDLE
30924,7457,23467,117331,42.317497,-71.096181,83000,CONDOMINIUM,TOWNHOUSE
718817,173349,545468,2727337,42.352928,-71.07292,2249000,CONDOMINIUM,ROW-MIDDLE
911168,219736,691432,3457160,42.341755,-71.079273,3075000,2-FAM RES,ROW-MIDDLE
208850,50366,158484,792419,42.382694,-71.03878,625000,2-FAM RES,CONDO/APT
418938,8159,410779,513473,42.312504,-71.108008,319000,CONDOMINIUM,DECKER
376355,48518,327837,938515,42.314357,-71.100646,730000,3-FAM RES,CONVENTIONAL
355811,85807,270004,1350020,42.348759,-71.06745,955000,3-FAM RES,ROW-MIDDLE
761224,119048,642176,2140587,42.358036,-71.051007,1665000,CONDOMINIUM,HIGH-RISE
200247,40056,160191,664359,42.291233,-71.059717,535000,1-FAM RES,COLONIAL
763883,184217,579666,2898326,42.36275,-71.051389,2390000,CONDOMINIUM,MID-RISE
434678,104826,329852,1649257,42.323104,-71.090178,1360000,RES DEV LAND,CONVENTIONAL
428485,51927,376558,1030145,42.352558,-71.130359,812500,2-FAM RES,CONDO/APT
218754,42104,176650,706601,42.358783,-71.14047,522000,3-FAM RES,CONVENTIONAL
37127,8953,28174,140866,42.319315,-71.088361,106250,CONDOMINIUM,FREE-STANDNG
115983,18138,97845,326147,42.33099,-71.112546,246000,CONDOMINIUM,ROW-MIDDLE
1586028,37104,1548924,2015936,42.357232,-71.070865,1295000,CONDOMINIUM,ROW-MIDDLE
119888,28912,90976,454879,42.300125,-71.116577,310000,1-FAM RES,COLONIAL
130915,31571,99344,496717,42.316384,-71.057845,400000,1-FAM RES,COLONIAL
375133,90466,284667,1423331,42.343865,-71.06958,970000,3-FAM RES,ROW-MIDDLE
59943,14455,45488,227439,42.346956,-71.155961,155000,1-FAM RES,COLONIAL
1598080,385391,1212689,6063445,42.355512,-71.136555,5000000,MXU RES+COM,CONDO/APT
223771,53964,169807,849035,42.379071,-71.061407,650000,1-FAM RES,SEMI DETACHD
154919,37360,117559,587793,42.379251,-71.061269,450000,1-FAM RES,COLONIAL
294729,71076,223653,1118265,42.380605,-71.027619,950000,3-FAM RES,DECKER
247649,70408,177240,886203,42.326095,-71.05802,690000,3-FAM RES,DECKER
519617,136441,383176,2100507,42.329656,-71.054453,1656720,3-FAM RES,DECKER
471820,49040,422780,1040037,42.351339,-71.068283,615000,CONDOMINIUM,ROW-MIDDLE
97839,23594,74245,371224,42.315331,-71.086445,280000,3-FAM RES,DECKER
231737,36241,195496,651651,42.315331,-71.086445,498888,3-FAM RES,DECKER
2156181,519982,1636199,8180992,42.351851,-71.070215,6950000,CONDOMINIUM,HIGH-RISE
777306,187454,589852,2949259,42.351851,-71.070215,2375000,CONDOMINIUM,HIGH-RISE
145194,35014,110180,550897,42.365011,-71.051232,490000,CONDOMINIUM,MID-RISE
503040,121312,381728,1908636,42.365011,-71.051232,1410000,CONDOMINIUM,MID-RISE
3287867,315636,2972231,6945014,42.351352,-71.083959,5900000,9 + UNIT APT,CONDO/APT
54161,13061,41100,205499,42.380324,-71.028755,155000,1-FAM RES,ROW-END
151096,36438,114658,573288,42.344375,-71.140589,339000,CONDOMINIUM,MID-RISE
987614,238172,749442,3747209,42.378656,-71.039908,3090000,MANUFACTURNG,CONDO/APT
1844561,444832,1399729,6998642,42.352767,-71.082359,6225000,CONDOMINIUM,LOW-RISE
948208,228669,719539,3597695,42.352767,-71.082359,3200000,CONDOMINIUM,LOW-RISE
133631,32226,101405,507025,42.300647,-71.115951,418100,CONDOMINIUM,FREE-STANDNG
754687,118026,636661,2122205,42.344671,-71.139312,1750000,3-FAM RES,DECKER
2599914,147794,2452120,4312348,42.354411,-71.074474,2550000,CONDOMINIUM,ROW-END
668320,161171,507149,2535742,42.350074,-71.086003,2000000,CONDOMINIUM,ROW-MIDDLE
522092,125907,396185,1980925,42.350074,-71.086003,1350000,CONDOMINIUM,ROW-MIDDLE
863403,208217,655186,3275928,42.341948,-71.068372,2750000,CONDOMINIUM,MID-RISE
433511,104545,328966,1644830,42.352876,-71.082308,995000,CONDOMINIUM,ROW-MIDDLE
1030953,248623,782330,3911649,42.342321,-71.07008,3150000,4-8 UNIT APT,CONDO/APT
194965,47017,147948,739740,42.367625,-71.036637,610000,3-FAM RES,ROW-MIDDLE
2176178,436981,1739197,7239295,42.327895,-71.077495,6150000,MXU RES+COM,CONDO/APT
303723,73245,230478,1152387,42.312061,-71.110712,1025000,2-FAM RES,TWO FAMILY
185377,44705,140672,703359,42.378209,-71.031814,580000,3-FAM RES,ROW-MIDDLE
692035,166890,525145,2625725,42.352852,-71.0824,1850000,CONDOMINIUM,ROW-MIDDLE
376380,90767,285613,1428062,42.333197,-71.037218,1150000,4-8 UNIT APT,ROW-MIDDLE
340843,82197,258646,1293228,42.350246,-71.080415,1020000,CONDOMINIUM,MID-RISE
219925,62526,157399,786996,42.378637,-71.030931,700000,3-FAM RES,ROW-MIDDLE
472831,114027,358804,1794017,42.333197,-71.037218,1506000,4-8 UNIT APT,ROW-MIDDLE
125656,30303,95353,476765,42.337307,-71.045815,365000,1-FAM RES,SEMI DETACHD
242175,58402,183773,918861,42.340892,-71.159407,650000,2-FAM RES,CONVENTIONAL
237455,57264,180191,900954,42.340914,-71.159394,614000,2-FAM RES,TWO FAMILY
1069885,187044,882841,3237083,42.364663,-71.051667,2750000,9 + UNIT APT,CONDO/APT
1113800,214377,899423,3597695,42.338584,-71.050694,3200000,MXU RES+COM,CONDO/APT
208850,50366,158484,792419,42.350359,-71.048463,625000,CONDOMINIUM,MID-RISE
883638,213097,670541,3352703,42.351461,-71.08427,2400000,4-8 UNIT APT,ROW-MIDDLE
2762890,666296,2096594,10482970,42.351461,-71.08427,8800000,1-FAM RES,ROW-MIDDLE
533367,128626,404741,2023704,42.344861,-71.13942,1800000,3-FAM RES,CONVENTIONAL
123677,29825,93852,469257,42.289093,-71.069692,365000,2-FAM RES,CONVENTIONAL
204554,49330,155224,776120,42.320201,-71.055712,625000,3-FAM RES,CONVENTIONAL
220839,53257,167582,837906,42.351918,-71.168623,632000,2-FAM RES,CONVENTIONAL
89548,21595,67953,339764,42.298432,-71.072067,251000,3-FAM RES,CONVENTIONAL
313256,60293,252963,1011852,42.318851,-71.054975,900000,2-FAM RES,DUPLEX
493664,119051,374613,1873064,42.337204,-71.074312,1325000,1-FAM RES,ROW-MIDDLE
33893,8173,25720,128596,42.286688,-71.077956,95000,3-FAM RES,DECKER
223731,53954,169777,848882,42.294298,-71.055686,700000,2-FAM RES,CONVENTIONAL
66013,56870,9143,724945,42.381261,-71.038645,555000,3-FAM RES,DECKER
1016527,245144,771383,3856913,42.350059,-71.082524,3000000,3-FAM RES,ROW-END
314094,75746,238348,1191736,42.391103,-71.002291,1060000,3-FAM RES,DECKER
165978,40027,125951,629755,42.319804,-71.076194,475000,3-FAM RES,ROW-END
576910,139127,437783,2188915,42.312699,-71.112558,1837500,BOARDING HSE,CONDO/APT
967923,275188,692734,3463674,42.344787,-71.077767,2225000,3-FAM RES,ROW-MIDDLE
158370,66936,91434,933938,42.290029,-71.047086,715000,3-FAM RES,DECKER
296315,71459,224856,1124280,42.332808,-71.04915,1000000,3-FAM RES,DECKER
123086,29683,93403,467012,42.256612,-71.113551,300000,1-FAM RES,COLONIAL
112600,27154,85446,427226,42.294681,-71.07983,380000,CONDOMINIUM,DUPLEX
67064,16173,50891,254454,42.319001,-71.065695,180000,2-FAM RES,CONVENTIONAL
196756,47449,149307,746534,42.346353,-71.161045,551500,2-FAM RES,TWO FAMILY
621766,149944,471822,2359108,42.351851,-71.070215,1395000,CONDOMINIUM,HIGH-RISE
920456,221976,698480,3492399,42.356155,-71.072377,2500000,1-FAM RES,ROW-MIDDLE
2454652,591961,1862691,9313451,42.356155,-71.072377,7500000,1-FAM RES,ROW-MIDDLE
26141,6304,19837,99185,42.288134,-71.091113,60000,ACC LAND IMP,CONDO/APT
1516705,365767,1150938,5754689,42.339957,-71.157223,3815000,9 + UNIT APT,CONDO/APT
1516705,365767,1150938,5754689,42.339946,-71.157263,3815000,9 + UNIT APT,CONDO/APT
99659,87230,12429,1110358,42.34427,-71.140548,837500,GEN OFFICE,CONVENTIONAL
247702,59735,187967,939834,42.376968,-71.030746,775000,3-FAM RES,DECKER
358111,68926,289185,1156738,42.346532,-71.074241,815000,CONDOMINIUM,ROW-MIDDLE
218335,52653,165682,828408,42.334434,-71.054811,645000,CONDOMINIUM,LOW-RISE
162143,39102,123041,615205,42.33377,-71.053226,479000,1-FAM RES,COLONIAL
272610,65742,206868,1034337,42.380783,-71.029321,920000,3-FAM RES,DECKER
90262,21767,68495,342475,42.305213,-71.059132,220000,2-FAM RES,TWO FAMILY
251489,60648,190841,954202,42.335891,-71.151281,675000,CONDOMINIUM,MID-RISE
133012,55400,77612,774908,42.377378,-71.0393,639000,2-FAM RES,ROW-MIDDLE
170204,41046,129158,645786,42.344318,-71.140495,455000,CONDOMINIUM,MID-RISE
619675,149440,470235,2351174,42.352757,-71.082766,1800000,CONDOMINIUM,ROW-MIDDLE
138676,33443,105233,526166,42.32273,-71.103997,415000,CONDOMINIUM,LOW-RISE
1230886,192499,1038387,3461288,42.321476,-71.109988,2730000,MXU RES+COM,CONDO/APT
206190,49724,156466,782329,42.320287,-71.081377,630000,MXU RES+COM,RAISED CAPE
452864,109212,343652,1718260,42.314055,-71.100159,1230000,3-FAM RES,ROW-END
128485,22462,106023,388749,42.314023,-71.10019,275000,3-FAM RES,CONDO/APT
1930884,465650,1465234,7326166,42.352546,-71.078703,6150000,CONDOMINIUM,MID-RISE
981106,236602,744504,3722518,42.351398,-71.084514,2750000,1-FAM RES,ROW-MIDDLE
372555,58264,314291,1047637,42.377454,-71.039059,890000,3-FAM RES,ROW-MIDDLE
261045,62953,198092,990462,42.367287,-71.036342,675000,9 + UNIT APT,CONDO/APT
609841,147068,462773,2313865,42.290685,-71.073261,1825000,MXU COM+RES,CONDO/APT
236953,57143,179810,899047,42.286136,-71.144972,700000,SHOPCTR/MALL,CONDO/APT
104828,25280,79548,397740,42.345182,-71.139758,300000,CONDOMINIUM,LOW-RISE
1102727,265932,836795,4183975,42.348152,-71.050169,3300000,CONDOMINIUM,MID-RISE
1900143,458236,1441907,7209532,42.35273,-71.082136,5100000,9 + UNIT APT,ROW-MIDDLE
889065,214406,674659,3373295,42.35273,-71.082136,2298900,9 + UNIT APT,ROW-MIDDLE
1391473,335566,1055907,5279532,42.35273,-71.082136,3500000,9 + UNIT APT,ROW-MIDDLE
1074142,259039,815103,4075515,42.352925,-71.078634,3625000,4-8 UNIT APT,CONDO/APT
778636,40594,738042,1248993,42.351356,-71.084677,880000,CONDOMINIUM,ROW-MIDDLE
120553,29072,91481,457401,42.37759,-71.039062,345000,MXU RES+COM,RAISED CAPE
438693,21066,417627,682787,42.342473,-71.088869,515000,CONDOMINIUM,ROW-MIDDLE
431592,104082,327510,1637550,42.308466,-71.105684,1275000,WAREHOUSE,RAISED CAPE
68,16,52,256,42.31177,-71.099748,200,CTYMUNI PROP,LOW-RISE
173763,41904,131859,659291,42.297319,-71.086052,519999,4-8 UNIT APT,CONDO/APT
216948,33928,183020,610067,42.320425,-71.055968,475000,1-FAM RES,CONVENTIONAL
2028571,102041,1926530,3210883,42.345194,-71.072652,2500000,1-FAM RES,ROW-MIDDLE
556387,134177,422210,2111049,42.285854,-71.127014,1700000,3-FAM RES,CONDO/APT
72779,17551,55228,276136,42.318697,-71.080556,215000,3-FAM RES,DECKER
959902,162049,797853,2837498,42.350178,-71.082449,2285000,CONDOMINIUM,ROW-END
959902,162049,797853,2837498,42.350115,-71.082294,2285000,CONDOMINIUM,ROW-END
107029,25811,81218,406092,42.359904,-71.068657,300000,CONDOMINIUM,ROW-MIDDLE
446746,107736,339010,1695048,42.384733,-71.01432,1365000,4-8 UNIT APT,CONDO/APT
287335,69293,218042,1090207,42.337072,-71.149,899000,2-FAM RES,SEMI DETACHD
286057,68985,217072,1085356,42.337056,-71.149035,895000,2-FAM RES,SEMI DETACHD
220850,75045,145805,1090369,42.367813,-71.038399,860000,2-FAM RES,CONVENTIONAL
356778,86040,270738,1353689,42.336934,-71.027091,1150000,2-FAM RES,CONVENTIONAL
387802,93521,294281,1471401,42.314935,-71.058335,1250000,1-FAM RES,COLONIAL
274462,66189,208273,1041366,42.353564,-71.166863,810000,2-FAM RES,CONVENTIONAL
490164,66327,423837,1258666,42.380552,-71.027586,980000,4-8 UNIT APT,CONDO/APT
1438642,346941,1091701,5458502,42.356988,-71.07044,4250000,4-8 UNIT APT,ROW-MIDDLE
61812,25771,36041,360415,42.320863,-71.05925,258000,CONDOMINIUM,DECKER
242601,58505,184096,920477,42.345828,-71.137746,680000,2-FAM RES,CONVENTIONAL
520878,125614,395264,1976318,42.351555,-71.127111,1460000,4-8 UNIT APT,CONDO/APT
1424841,274244,1150597,4602386,42.311329,-71.05693,3400000,9 + UNIT APT,CONDO/APT
2318978,559242,1759736,8798680,42.350958,-71.131657,6500000,MXU RES+COM,CONDO/APT
57640,11235,46405,187821,42.339262,-71.151932,128000,CONDOMINIUM,ROW-END
1820298,233939,1586359,4530848,42.342465,-71.072514,4030000,4-8 UNIT APT,CONDO/APT
169522,40881,128641,643203,42.320756,-71.108367,455000,3-FAM RES,DECKER
1351716,325978,1025738,5128688,42.353717,-71.129604,3400000,9 + UNIT APT,CONDO/APT
754353,181919,572434,2862170,42.352685,-71.083041,2431500,CONDOMINIUM,ROW-MIDDLE
754353,181919,572434,2862170,42.352685,-71.083041,2431500,CONDOMINIUM,ROW-MIDDLE
343651,82874,260777,1303883,42.341956,-71.070684,1050000,CONDOMINIUM,ROW-MIDDLE
343651,82874,260777,1303883,42.341956,-71.070684,1050000,CONDOMINIUM,ROW-MIDDLE
1737631,419045,1318586,6592930,42.352706,-71.082228,5200000,1-FAM RES,ROW-MIDDLE
1427113,344161,1082952,5414757,42.352979,-71.07866,4600000,CONDOMINIUM,ROW-END
301590,20755,280835,542076,42.366214,-71.051154,415000,CONDOMINIUM,MID-RISE
338504,81633,256871,1284353,42.331187,-71.05393,1000000,MXU RES+COM,ROW-MIDDLE
279198,67331,211867,1059334,42.352661,-71.083132,811000,CONDOMINIUM,ROW-MIDDLE
283319,62938,220381,1012559,42.311518,-71.102662,850000,2-FAM RES,CONVENTIONAL
2927314,215456,2711858,5423715,42.352683,-71.082319,4152260,9 + UNIT APT,CONDO/APT
76960,18559,58401,292003,42.304959,-71.084057,199000,3-FAM RES,DECKER
263362,63512,199850,999249,42.31169,-71.10249,765000,3-FAM RES,CONVENTIONAL
103252,16147,87105,290350,42.337234,-71.152105,219000,CONDOMINIUM,LOW-RISE
167250,57259,109991,830692,42.380571,-71.0281,685000,3-FAM RES,DECKER
608062,95095,512967,1709891,42.345313,-71.140349,1410000,3-FAM RES,DECKER
237190,57200,179990,899946,42.378527,-71.031499,700000,3-FAM RES,DECKER
240025,37537,202488,674959,42.331101,-71.053878,525000,CONDOMINIUM,ROW-END
240025,37537,202488,674959,42.331101,-71.053878,525000,CONDOMINIUM,ROW-END
174886,42175,132711,663555,42.352916,-71.078758,475000,CONDOMINIUM,ROW-MIDDLE
660082,159184,500898,2504489,42.352635,-71.082503,1950000,CONDOMINIUM,ROW-MIDDLE
249850,48089,201761,807043,42.338402,-71.050406,550000,MXU RES+COM,RAISED CAPE
599715,93790,505925,1686419,42.310966,-71.102907,1500000,3-FAM RES,DECKER
432024,104186,327838,1639188,42.348959,-71.152103,1275000,MXU COM+RES,RAISED CAPE
238613,57543,181070,905347,42.35004,-71.088819,760000,CONDOMINIUM,MID-RISE
236404,57010,179394,896966,42.357947,-71.050993,762000,CONDOMINIUM,HIGH-RISE
960587,231654,728933,3644664,42.349285,-71.086613,2935000,CONDOMINIUM,MID-RISE
0,0,0,1,42.349285,-71.086613,1,CONDOMINIUM,MID-RISE
0,0,0,1,42.349285,-71.086613,1,CONDOMINIUM,MID-RISE
296191,71429,224762,1123809,42.349565,-71.087529,875000,CONDOMINIUM,MID-RISE
718542,204287,514255,2571275,42.349285,-71.086613,2000000,CONDOMINIUM,MID-RISE
169420,40857,128563,642813,42.349285,-71.086613,499996,CONDOMINIUM,MID-RISE
423553,102143,321410,1607047,42.349285,-71.086613,1250000,CONDOMINIUM,MID-RISE
423553,102143,321410,1607047,42.349285,-71.086613,1250000,CONDOMINIUM,MID-RISE
1510742,364329,1146413,5732063,42.348727,-71.086197,3800000,MXU RES+COM,RAISED CAPE
3287247,792749,2494498,12472490,42.348727,-71.086197,8500000,MXU RES+COM,RAISED CAPE
238818,89912,148906,1280590,42.367108,-71.035929,1075000,MXU RES+COM,RAISED CAPE
119459,28808,90651,453254,42.364335,-71.052291,347000,CONDOMINIUM,FREE-STANDNG
82339,19856,62483,312413,42.297683,-71.0746,221000,3-FAM RES,CONVENTIONAL
561287,108032,453255,1813018,42.310582,-71.112407,1460000,3-FAM RES,CONVENTIONAL
885356,143199,742157,2544540,42.360169,-71.067898,1800000,9 + UNIT APT,CONDO/APT
139608,33667,105941,529704,42.288149,-71.126312,450000,1-FAM RES,BNGL/COTTAGE
228477,43975,184502,738007,42.31208,-71.079186,565000,3-FAM RES,DECKER
79845,35982,43863,496758,42.377842,-71.063337,350000,CONDOMINIUM,DECKER
63711,15364,48347,241731,42.278763,-71.092432,171000,3-FAM RES,CONVENTIONAL
372290,89781,282509,1412545,42.340577,-71.160244,1200000,2-FAM RES,CONVENTIONAL
1495208,183858,1311350,3625498,42.343658,-71.070036,2820000,4-8 UNIT APT,CONDO/APT
384443,73995,310448,1241793,42.325138,-71.0577,1000000,3-FAM RES,DECKER
227024,54748,172276,861377,42.380263,-71.06802,670000,1-FAM RES,ROW-END
413824,193531,220293,2656190,42.364478,-71.056519,2095000,4-8 UNIT APT,CONDO/APT
379064,91414,287650,1438249,42.308358,-71.12578,1186000,1-FAM RES,SPLIT LEVEL
374838,90395,284443,1422214,42.33427,-71.102931,1265000,3-FAM RES,ROW-MIDDLE
2556323,616480,1939843,9699215,42.353258,-71.074211,7650000,CONDOMINIUM,ROW-MIDDLE
98264,23697,74567,372835,42.348548,-71.131647,290000,CONDOMINIUM,LOW-RISE
387802,93521,294281,1471401,42.353066,-71.078832,1250000,CONDOMINIUM,MID-RISE
214045,20428,193617,450744,42.338194,-71.148105,350600,CONDOMINIUM,LOW-RISE
122855,29627,93228,466139,42.34971,-71.132899,396000,CONDOMINIUM,LOW-RISE
127119,30655,96464,482316,42.3501,-71.132087,429000,CONDOMINIUM,MID-RISE
110202,26576,83626,418127,42.33837,-71.152471,351000,CONDOMINIUM,LOW-RISE
128568,31005,97563,487815,42.33939,-71.154857,409500,CONDOMINIUM,MID-RISE
401139,96738,304401,1522005,42.352637,-71.083224,900000,CONDOMINIUM,HIGH-RISE
537788,129692,408096,2040476,42.352637,-71.083224,1206585,CONDOMINIUM,HIGH-RISE
573698,110800,462898,1857490,42.310472,-71.10369,1531712,CHARITY PROP,DUPLEX
276794,43288,233506,778353,42.36427,-71.053805,500000,MXU COM+RES,CONDO/APT
88363,21309,67054,335270,42.304886,-71.083844,240000,3-FAM RES,DECKER
250389,35964,214425,667098,42.338083,-71.048808,560000,CONDOMINIUM,DECKER
66273,15982,50291,251452,42.292435,-71.089843,180000,4-8 UNIT APT,DECKER
166194,40079,126115,630575,42.32057,-71.116577,497350,CONDOMINIUM,LOW-RISE
158368,30481,127887,511547,42.322706,-71.105084,455000,CONDOMINIUM,ROW-END
567937,105070,462867,1785343,42.349719,-71.087308,1080000,CONDOMINIUM,MID-RISE
147279,35517,111762,558807,42.381226,-71.067427,450000,1-FAM RES,CONVENTIONAL
295127,71172,223955,1119771,42.31924,-71.081315,940000,MXU RES+COM,RAISED CAPE
269910,65091,204819,1024095,42.377908,-71.029293,870000,1-FAM RES,CONVENTIONAL
310768,74944,235824,1179120,42.346106,-71.075097,930000,CONDOMINIUM,ROW-MIDDLE
508263,122572,385691,1928456,42.332203,-71.037191,1500000,MXU COM+RES,RAISED CAPE
227624,54893,172731,863653,42.37648,-71.031319,725000,3-FAM RES,DECKER
434338,104744,329594,1647969,42.349252,-71.087112,1400000,CONDOMINIUM,ROW-MIDDLE
1041828,158987,882841,2883946,42.319044,-71.081358,2450000,MXU RES+COM,CONDO/APT
1316356,317451,998905,4994521,42.308809,-71.105344,3888743,REST/BAR,CONDO/APT
1234455,90858,1143597,2287193,42.362965,-71.051673,1920000,CONDOMINIUM,MID-RISE
192382,36944,155438,620448,42.285738,-71.13003,475000,2-FAM RES,CONVENTIONAL
846960,204252,642708,3213540,42.344471,-71.06927,2730000,CONDOMINIUM,ROW-MIDDLE
367431,88609,278822,1394107,42.351224,-71.141222,1240000,2-FAM RES,TWO FAMILY
61811,14906,46905,234521,42.303915,-71.080841,165900,3-FAM RES,SEMI DETACHD
403314,97262,306052,1530257,42.360547,-71.064454,1300000,CONDOMINIUM,MID-RISE
124650,30060,94590,472948,42.381776,-71.018675,390000,1-FAM RES,CONVENTIONAL
1279278,308509,970769,4853844,42.35721,-71.070947,2825000,1-FAM RES,ROW-MIDDLE
208573,50299,158274,791370,42.29182,-71.145628,596900,1-FAM RES,CAPE COD
96092,23173,72919,364595,42.322267,-71.078428,275000,3-FAM RES,CONVENTIONAL
308690,74443,234247,1171235,42.284354,-71.054699,995000,2-FAM RES,CONVENTIONAL
341266,82299,258967,1294833,42.308641,-71.114302,1100000,2-FAM RES,TWO FAMILY
384609,74027,310582,1242329,42.30436,-71.066794,1105000,CONDOMINIUM,DECKER
384609,74027,310582,1242329,42.30436,-71.066794,1105000,CONDOMINIUM,DECKER
384609,74027,310582,1242329,42.30436,-71.066794,1105000,CONDOMINIUM,DECKER
153358,36975,116383,581775,42.310279,-71.069022,409900,3-FAM RES,DECKER
30983,7471,23512,117558,42.26145,-71.159615,90000,1-FAM RES,CAPE COD
49947,12045,37902,189510,42.377393,-71.036013,140000,3-FAM RES,DECKER
119504,28819,90685,453424,42.388825,-71.009368,342000,1-FAM RES,COLONIAL
1255859,302861,952998,4764986,42.352488,-71.08377,4000000,CONDOMINIUM,ROW-MIDDLE
522092,125907,396185,1980925,42.352876,-71.082308,1350000,CONDOMINIUM,ROW-MIDDLE
300410,72446,227964,1139816,42.331881,-71.037303,899000,2-FAM RES,CONVENTIONAL
512191,47228,464963,1059409,42.377799,-71.039189,900000,3-FAM RES,ROW-MIDDLE
1757888,423930,1333958,6669789,42.345267,-71.084125,5500000,CONDOMINIUM,HIGH-RISE
850946,205213,645733,3228663,42.352468,-71.083143,2600000,CONDOMINIUM,ROW-MIDDLE
0,0,0,1,42.349624,-71.08767,1,CONDOMINIUM,ROW-MIDDLE
0,0,0,1,42.349624,-71.08767,1,CONDOMINIUM,ROW-MIDDLE
0,0,0,1,42.349624,-71.08767,1,CONDOMINIUM,ROW-MIDDLE
0,0,0,1,42.349624,-71.08767,1,CONDOMINIUM,ROW-MIDDLE
0,0,0,1,42.349624,-71.08767,1,CONDOMINIUM,ROW-MIDDLE
1857815,257578,1600237,4842267,42.280234,-71.064446,3993000,9 + UNIT APT,CONDO/APT
180409,43507,136902,684510,42.280234,-71.064446,490000,9 + UNIT APT,CONDO/APT
110013,26530,83483,417414,42.283177,-71.084255,325000,3-FAM RES,CONVENTIONAL
1001660,142175,859485,2648990,42.33828,-71.050213,2028000,MXU COM+RES,CONDO/APT
214929,41368,173561,694244,42.381333,-71.067649,540000,CONDOMINIUM,MID-RISE
192991,137451,55540,1785586,42.322711,-71.105971,1367000,MXU RES+COM,CONDO/APT
1353348,326372,1026976,5134878,42.366072,-71.05123,4050000,CONDOMINIUM,ROW-MIDDLE
176816,104055,72761,1382465,42.378686,-71.031072,1140000,3-FAM RES,DECKER
653524,157603,495921,2479603,42.357195,-71.06499,1775000,CONDOMINIUM,MID-RISE
152018,36660,115358,576789,42.349577,-71.087851,490000,CONDOMINIUM,ROW-MIDDLE
152018,36660,115358,576789,42.349577,-71.087851,490000,CONDOMINIUM,ROW-MIDDLE
503736,121480,382256,1911276,42.338424,-71.04856,1700000,4-8 UNIT APT,CONDO/APT
165896,40007,125889,629444,42.350359,-71.048463,465000,CONDOMINIUM,MID-RISE
4442266,473032,3969234,9923084,42.350865,-71.08578,8330000,3-FAM RES,ROW-MIDDLE
717956,173141,544815,2724071,42.349553,-71.087942,1950000,CONDOMINIUM,ROW-MIDDLE
217706,52501,165205,826022,42.335496,-71.051188,642500,CONDOMINIUM,FREE-STANDNG
300744,72527,228217,1141084,42.377814,-71.029731,900000,3-FAM RES,DECKER
300744,72527,228217,1141084,42.377867,-71.029667,900000,RES UDV LAND,ROW-END
281500,67886,213614,1068066,42.297459,-71.056824,950000,3-FAM RES,DECKER
45572,19175,26397,267747,42.326896,-71.076515,177500,3-FAM RES,DECKER
599208,170359,428848,2144243,42.337844,-71.051487,1800000,3-FAM RES,DECKER
133228,24086,109142,412314,42.338762,-71.071597,340000,CONDOMINIUM,ROW-END
108669,26206,82463,412314,42.338762,-71.071597,340000,CONDOMINIUM,ROW-END
157404,37959,119445,597224,42.272374,-71.14742,465000,1-FAM RES,COLONIAL
157404,37959,119445,597224,42.272374,-71.14742,465000,1-FAM RES,COLONIAL
122299,29493,92806,464030,42.280968,-71.129082,350000,1-FAM RES,COLONIAL
171354,53196,118158,787717,42.351983,-71.16863,555000,2-FAM RES,CONVENTIONAL
697724,168262,529462,2647308,42.367042,-71.053861,1755000,9 + UNIT APT,CONDO/APT
96135,23183,72952,364756,42.320094,-71.080432,284000,3-FAM RES,SEMI DETACHD
4498508,1084856,3413652,17068256,42.353025,-71.074723,14500000,CONDOMINIUM,ROW-MIDDLE
277587,84692,192895,1258888,42.33198,-71.105712,930000,3-FAM RES,DECKER
284458,68599,215859,1079293,42.294347,-71.055704,890000,2-FAM RES,CONVENTIONAL
206986,55400,151586,848882,42.294347,-71.055704,700000,2-FAM RES,CONVENTIONAL
166967,40265,126702,633510,42.379345,-71.069964,485000,1-FAM RES,ROW-MIDDLE
1904638,297867,1606771,5355901,42.360024,-71.068786,4550000,9 + UNIT APT,CONDO/APT
52366,12628,39738,198686,42.288134,-71.091113,160000,RES DEV LAND,CONDO/APT
110013,26530,83483,417414,42.298924,-71.075416,325000,3-FAM RES,CONVENTIONAL
431481,104055,327426,1637130,42.390317,-71.0113,1350000,4-8 UNIT APT,CONDO/APT
196228,47322,148906,744529,42.284326,-71.145314,625000,1-FAM RES,COLONIAL
1333967,256753,1077214,4308854,42.364647,-71.056529,3250000,9 + UNIT APT,CONDO/APT
1608237,334684,1273553,5486074,42.364647,-71.056529,4200000,9 + UNIT APT,CONDO/APT
815030,155050,659980,2611532,42.364647,-71.056529,1840000,9 + UNIT APT,CONDO/APT
239073,57654,181419,907091,42.321455,-71.119618,748000,CONDOMINIUM,MID-RISE
263721,63598,200123,1000614,42.34197,-71.078323,705000,CONDOMINIUM,ROW-MIDDLE
174656,27314,147342,491139,42.333289,-71.043258,405000,CONDOMINIUM,ROW-END
1433955,38591,1395364,1881092,42.352637,-71.083224,1065000,CONDOMINIUM,HIGH-RISE
194965,47017,147948,739740,42.347556,-71.151671,610000,1-FAM RES,VICTORIAN
142017,34248,107769,538845,42.284781,-71.169134,425000,1-FAM RES,COLONIAL
35537,8570,26967,134834,42.374011,-71.051866,95000,CONDOMINIUM,MID-RISE
288768,106072,182696,1517778,42.331253,-71.046926,1350000,3-FAM RES,SEMI DETACHD
670227,49330,620897,1241793,42.350572,-71.086838,1000000,CONDOMINIUM,ROW-END
3191897,234930,2956967,5913934,42.359009,-71.064489,4600000,1-FAM RES,ROW-END
1519850,366525,1153325,5766621,42.350781,-71.08608,4755235,1-FAM RES,ROW-MIDDLE
108481,26161,82320,411600,42.36698,-71.035162,290000,3-FAM RES,SEMI DETACHD
3256565,239690,3016875,6033750,42.352349,-71.083584,4000000,1-FAM RES,ROW-MIDDLE
2132997,192695,1940302,4365680,42.364641,-71.053443,3600000,MXU COM+RES,RAISED CAPE
89777,21650,68127,340634,42.294724,-71.058366,240000,3-FAM RES,DECKER
32107,3721,28386,75223,42.291829,-71.090226,53000,CONDOMINIUM,FREE-STANDNG
153058,36911,116147,580732,42.366244,-71.051291,487500,CONDOMINIUM,MID-RISE
30768,19939,10829,261794,42.302201,-71.069197,193400,1-FAM RES,COLONIAL
49093,11839,37254,186269,42.323597,-71.085872,150000,CONDOMINIUM,LOW-RISE
134955,32545,102410,512047,42.283061,-71.130814,435000,1-FAM RES,COLONIAL
187458,120362,67096,1582050,42.345953,-71.071633,1344000,CONDOMINIUM,ROW-MIDDLE
33904,8176,25728,128640,42.262948,-71.159408,91000,1-FAM RES,CONVENTIONAL
111834,26969,84865,424322,42.308799,-71.061702,330378,3-FAM RES,DECKER
4607826,433677,4174149,9632651,42.352769,-71.07383,7500000,CONDOMINIUM,ROW-END
587446,170887,416559,2567439,42.336299,-71.075449,2025000,4-8 UNIT APT,CONDO/APT
639232,154156,485076,2425378,42.336493,-71.042799,2000000,3-FAM RES,DECKER
223771,53964,169807,849035,42.289336,-71.136932,650000,1-FAM RES,COLONIAL
253418,48776,204642,818565,42.335537,-71.083784,675000,CONDOMINIUM,LOW-RISE
43055,12240,30814,154071,42.366797,-71.038012,105000,CONDOMINIUM,ROW-END
2416292,102143,2314149,3599786,42.344665,-71.077948,2800000,2-FAM RES,ROW-MIDDLE
3383071,360244,3022827,7557067,42.357203,-71.070974,5700000,1-FAM RES,ROW-END
1059840,165749,894091,2980304,42.343914,-71.069679,2400000,2-FAM RES,ROW-MIDDLE
199759,48173,151586,757930,42.310038,-71.130166,625000,1-FAM RES,RANCH
813307,177552,635755,2870530,42.365469,-71.0546,2235000,4-8 UNIT APT,CONDO/APT
86978,36263,50715,507148,42.265935,-71.102772,400000,2-FAM RES,TWO FAMILY
297402,71721,225681,1128405,42.307125,-71.104831,890000,3-FAM RES,DECKER
87722,82971,4751,1049073,42.332076,-71.107361,775000,2-FAM RES,CONVENTIONAL
184628,44524,140104,700518,42.316661,-71.054765,450000,3-FAM RES,DECKER
282981,68243,214738,1073687,42.342825,-71.088249,955000,CONDOMINIUM,ROW-MIDDLE
336887,81243,255644,1278218,42.34256,-71.072625,915000,CONDOMINIUM,ROW-MIDDLE
499112,120365,378747,1893735,42.374175,-71.061116,1525000,1-FAM RES,ROW-MIDDLE
0,0,0,1,42.290528,-71.076067,1,CTYMUNI PROP,SEMI DETACHD
445165,47403,397762,994405,42.355265,-71.151465,820000,2-FAM RES,TWO FAMILY
159025,38350,120675,603375,42.327246,-71.100862,400000,3-FAM RES,DECKER
1458736,187561,1271175,3631927,42.348168,-71.087641,2825000,CONDOMINIUM,MID-RISE
535357,129106,406251,2031254,42.379217,-71.039345,1675000,CONDOMINIUM,FREE-STANDNG
744057,77078,666979,1637130,42.348168,-71.087641,1350000,CONDOMINIUM,MID-RISE
451314,108838,342476,1712378,42.348168,-71.087641,1100000,CONDOMINIUM,MID-RISE
676449,53773,622676,1299497,42.348168,-71.087641,960000,CONDOMINIUM,MID-RISE
188731,45514,143217,716085,42.337063,-71.046827,460000,2-FAM RES,TWO FAMILY
1427064,344149,1082915,5414572,42.348454,-71.086921,4000000,CONDOMINIUM,MID-RISE
1856970,447825,1409145,7045723,42.345267,-71.084125,5810000,CONDOMINIUM,HIGH-RISE
4110301,437683,3672618,9181545,42.352167,-71.084516,7800000,CONDOMINIUM,ROW-MIDDLE
1806691,259888,1546803,4817910,42.364715,-71.053371,3800000,MXU COM+RES,CONDO/APT
318539,76818,241721,1208601,42.366819,-71.034798,1075000,1-FAM RES,ROW-END
193479,46659,146820,734097,42.348882,-71.088439,579000,CONDOMINIUM,MID-RISE
372290,89781,282509,1412545,42.338041,-71.047549,1200000,1-FAM RES,SEMI DETACHD
1262706,518177,744529,7266604,42.338468,-71.048031,6100000,RELIGIOUS PR,SEMI DETACHD
130820,31548,99272,496359,42.366166,-71.030059,380000,2-FAM RES,CONVENTIONAL
189752,45760,143992,719957,42.378636,-71.03909,560000,3-FAM RES,DECKER
259021,62465,196556,982778,42.294798,-71.058088,825000,CONDOMINIUM,FREE-STANDNG
259021,62465,196556,982778,42.294798,-71.058088,825000,CONDOMINIUM,FREE-STANDNG
259021,62465,196556,982778,42.294798,-71.058088,825000,CONDOMINIUM,FREE-STANDNG
0,0,0,1,42.294798,-71.058088,1,CONDOMINIUM,FREE-STANDNG
0,0,0,1,42.294798,-71.058088,1,CONDOMINIUM,FREE-STANDNG
271773,52482,219291,879868,42.330455,-71.055488,650000,3-FAM RES,CONDO/APT
91404,49605,41799,666166,42.366095,-71.029897,510000,3-FAM RES,DECKER
391853,61282,330571,1101903,42.294816,-71.058019,925000,3-FAM RES,DECKER
426941,102960,323981,1619903,42.352157,-71.084225,1260000,CONDOMINIUM,ROW-MIDDLE
147689,35616,112073,560363,42.334884,-71.045217,429000,1-FAM RES,COLONIAL
93107,22453,70654,353267,42.285138,-71.068562,249900,3-FAM RES,CONVENTIONAL
361432,87162,274270,1371346,42.375333,-71.037433,1165000,MXU RES+COM,RAISED CAPE
68927,16622,52305,261522,42.297387,-71.07353,185000,2-FAM RES,CONVENTIONAL
219508,37774,181734,657185,42.278625,-71.135763,518338,CONDOMINIUM,FREE-STANDNG
527410,127189,400221,2001105,42.370759,-71.037621,1700000,4-8 UNIT APT,CONDO/APT
254917,80585,174332,1188629,42.334431,-71.051059,937500,3-FAM RES,DECKER
455123,88794,366329,1483943,42.334414,-71.051078,1195000,3-FAM RES,DECKER
463796,111848,351948,1759736,42.364549,-71.057044,1300000,4-8 UNIT APT,CONDO/APT
175575,42341,133234,666166,42.330252,-71.104453,510000,1-FAM RES,CONVENTIONAL
192833,30157,162676,542252,42.345808,-71.073781,409000,CONDOMINIUM,ROW-MIDDLE
684443,165059,519384,2596917,42.37587,-71.061926,2180000,CONDOMINIUM,ROW-END
147631,46375,101256,684966,42.27294,-71.071537,575000,4-8 UNIT APT,CONDO/APT
210173,63033,147140,940519,42.359673,-71.067729,799000,CONDOMINIUM,MID-RISE
821355,198077,623278,3116386,42.342022,-71.07837,2424000,CONDOMINIUM,ROW-MIDDLE
330391,79676,250715,1253572,42.315487,-71.055348,1115000,3-FAM RES,DECKER
1216958,366074,850884,5458502,42.366438,-71.055669,4250000,9 + UNIT APT,CONDO/APT
143827,34685,109142,545710,42.317286,-71.05787,450000,3-FAM RES,DECKER
761364,183609,577755,2888773,42.342022,-71.07837,2425000,CONDOMINIUM,ROW-MIDDLE
773072,59196,713876,1458952,42.344336,-71.156258,1174875,2-FAM RES,CONVENTIONAL
1787340,110988,1676352,3073311,42.349561,-71.069088,2200000,1-FAM RES,ROW-MIDDLE
404113,77917,326196,1306904,42.349561,-71.069088,924500,1-FAM RES,ROW-MIDDLE
392517,75549,316968,1267871,42.355418,-71.158542,1000000,2-FAM RES,CONVENTIONAL
279543,67414,212129,1060641,42.35388,-71.139044,800000,2-FAM RES,CONDO/APT
1885333,454665,1430668,7153340,42.355213,-71.062168,4875000,GEN OFFICE,CONDO/APT
266882,41807,225075,751285,42.36678,-71.034947,605000,CONDOMINIUM,ROW-END
954053,230078,723975,3619876,42.345267,-71.084125,2985000,CONDOMINIUM,HIGH-RISE
133435,32179,101256,506279,42.272689,-71.123407,425000,2-FAM RES,TWO FAMILY
174713,42133,132580,662900,42.322007,-71.112249,500000,1-FAM RES,COLONIAL
429870,82738,347132,1388528,42.313038,-71.101036,1145000,MXU COM+RES,RAISED CAPE
144661,34886,109775,548872,42.336976,-71.046692,442000,CONDOMINIUM,DECKER
271462,65465,205997,1029981,42.349307,-71.0909,875000,CONDOMINIUM,MID-RISE
751098,181134,569964,2849819,42.336592,-71.086168,2350000,3-FAM RES,ROW-MIDDLE
751098,181134,569964,2849819,42.336608,-71.086184,2350000,3-FAM RES,ROW-MIDDLE
405000,97669,307331,1536655,42.298681,-71.072998,1100000,MXU RES+COM,CONDO/APT
1175282,221503,953779,3741747,42.352083,-71.084472,2550000,1-FAM RES,ROW-MIDDLE
